,broker,count,bamount,bcount,samount,scount,top3
0,中国银河证券股份有限公司杭州庆春路证券营业部,3,5397.51,2,1406.02,1,"泰达股份,张家港行,东旭蓝天"
1,东方证券股份有限公司杭州体育场路证券营业部,2,5465.83,1,4393.98,1,渤海股份
2,海通证券股份有限公司许昌建设路证券营业部,5,9484.48,3,6786.28,2,"京汉股份,三超新材"
3,光大证券股份有限公司佛山季华六路证券营业部,5,8910.39,4,1801.82,1,"中油工程,神州长城,科林电气,"
4,国海证券股份有限公司太原体育路证券营业部,2,3216.37,1,793.43,1,"泰达股份,东方中科"
5,国泰君安证券股份有限公司上海江苏路证券营业部,9,14539.74,6,4601.82,3,"先河环保,华斯股份,神州长城,"
6,国泰君安证券股份有限公司杭州五星路证券营业部,5,7235.36,2,7494.33,3,"渤海股份,青龙管业"
7,广州证券股份有限公司常州高新科技园证券营业部,10,6482.13,5,7240.36,5,"京汉股份,坤彩科技,钧达股份,"
8,中信证券（山东）有限责任公司淄博分公司,8,12436.37,6,5611.45,2,"恒泰艾普,泰达股份,四通新材,"
9,华泰证券股份有限公司成都南一环路第二证券营业部,8,18764.88,7,4153.77,1,"建新股份,太极实业,银江股份,"
10,华泰证券股份有限公司溧水珍珠南路证券营业部,2,2238.76,1,2353.03,1,渤海股份
11,海通证券股份有限公司绵阳长虹大道证券营业部,1,1532.75,1,0.0,0,京汉股份
12,长江证券股份有限公司深圳福华一路证券营业部,1,2238.2,1,0.0,0,泰达股份
13,万和证券股份有限公司成都通盈街证券营业部,4,4380.82,3,2061.98,1,"神州长城,禾丰牧业,钧达股份,"
14,中信证券股份有限公司诸暨暨东路证券营业部,1,1327.01,1,0.0,0,京汉股份
15,中泰证券股份有限公司宁波江东北路证券营业部,7,8130.14,4,3755.05,3,"清源股份,兰石重装,神州长城,"
16,华泰证券股份有限公司厦门厦禾路证券营业部,32,45546.7,18,31441.8,14,"冀东装备,柳钢股份,恒泰艾普,"
17,中信建投证券股份有限公司上海华灵路证券营业部,2,2058.84,2,0.0,0,"京汉股份,莱茵体育"
18,申万宏源证券有限公司瑞安安盛路证券营业部,2,3623.6,2,0.0,0,"天山股份,渤海股份"
19,中国银河证券股份有限公司西安友谊东路证券营业部,2,0.0,0,2296.14,2,"泰达股份,永和智控"
20,华宝证券有限责任公司舟山岱山人民路证券营业部,4,1708.56,1,7694.14,3,"京汉股份,华斯股份"
21,华泰证券股份有限公司扬州宝应叶挺东路证券营业部,2,3626.81,1,3183.34,1,"先河环保,渤海股份"
22,华泰证券股份有限公司深圳深南大道证券营业部,4,85.79,1,6393.29,3,"强力新材,光正集团,泰达股份,"
23,华宝证券有限责任公司福州八一七北路证券营业部,4,960.78,2,2506.81,2,"京汉股份,星云股份,广和通"
24,华泰证券股份有限公司江阴分公司,7,4067.2,3,6070.11,4,"河北宣工,江阴银行,渤海股份,"
25,国信证券股份有限公司北京三里河证券营业部,7,1011.05,1,2104.17,6,"华灿光电,泰达股份,永和智控,"
26,华泰证券股份有限公司上海武定路证券营业部,24,21310.25,11,22637.83,13,"三超新材,钧达股份,青龙管业,"
27,东兴证券股份有限公司深圳中兴路证券营业部,4,778.37,1,12037.38,3,"陇神戎发,光正集团,渤海股份"
28,华泰证券股份有限公司天津勤俭道证券营业部,1,0.0,0,687.45,1,泰达股份
29,西南证券股份有限公司福州井大路证券营业部,2,0.0,0,2385.97,2,"神州长城,焦作万方"
30,国信证券股份有限公司南京洪武路证券营业部,3,1609.96,1,1152.17,2,"八一钢铁,京汉股份,金能科技"
31,广发证券股份有限公司深圳新安二路证券营业部,1,0.0,0,1420.6,1,渤海股份
32,中航证券有限公司宜春东风大街证券营业部,1,0.0,0,583.25,1,泰达股份
33,国金证券股份有限公司上海奉贤区金碧路证券营业部,48,15977.39,23,12291.88,25,"冀东装备,京汉股份,河北宣工,"
34,浙商证券股份有限公司绍兴解放北路证券营业部,10,23591.77,4,32130.6,6,"天山股份,冀东装备,张家港行,"
35,广发证券股份有限公司西安南广济街证券营业部,3,20902.23,2,4727.36,1,"新兴铸管,中化岩土"
36,广发证券股份有限公司广州天河路证券营业部,3,7152.31,3,0.0,0,锦龙股份
37,中信证券股份有限公司上海溧阳路证券营业部,21,40591.61,14,18816.58,7,"天山股份,韩建河山,嘉寓股份,"
38,中信证券股份有限公司上海淮海中路证券营业部,23,69688.04,12,38685.92,11,"新兴铸管,嘉寓股份,冀东水泥,"
39,华泰证券股份有限公司武汉新华路证券营业部,7,5399.09,6,1680.7,1,"锦龙股份,中持股份,今飞凯达,"
40,中信建投证券股份有限公司绍兴胜利东路证券营业部,17,22734.86,10,15677.48,7,"冀东装备,津膜科技,长川科技,"
41,招商证券股份有限公司深圳蛇口工业七路证券营业部,10,17900.61,6,10070.56,4,"清源股份,坤彩科技,冀东装备,"
42,中国银河证券股份有限公司北京阜成路证券营业部,12,29363.92,6,26506.55,6,"新兴铸管,中化岩土,青龙管业,"
43,广发证券股份有限公司佛山顺德建设南路证券营业部,2,2354.46,2,0.0,0,"张家港行,锦龙股份"
44,中国中投证券有限责任公司深圳深南中路证券营业部,3,12110.46,2,5269.52,1,"中成股份,冀东装备"
45,中国国际金融股份有限公司北京科学院南路证券营业部,1,1827.33,1,0.0,0,天山股份
46,华福证券有限责任公司仙游八二五大街证券营业部,3,3778.39,3,0.0,0,锦龙股份
47,中国中投证券有限责任公司南京太平南路证券营业部,8,15787.59,5,4653.22,3,"新兴铸管,千方科技,陇神戎发,"
48,光大证券股份有限公司温州划龙桥路证券营业部,1,4292.32,1,0.0,0,新兴铸管
49,国信证券股份有限公司广州东风中路证券营业部,5,3670.51,2,1324.51,3,"中房地产,锦龙股份,金石资源,"
50,财通证券股份有限公司绍兴人民中路证券营业部,7,12987.59,6,2336.35,1,"永和智控,银江股份,兔宝宝,"
51,中国银河证券股份有限公司绍兴证券营业部,8,9743.16,2,16542.86,6,"冀东装备,联泰环保,微光股份,"
52,华泰证券股份有限公司牡丹江西一条路证券营业部,1,0.0,0,4511.69,1,新兴铸管
53,国泰君安证券股份有限公司上海福山路证券营业部,28,22203.56,13,43496.52,15,"力盛赛车,京汉股份,银龙股份,"
54,国泰君安证券股份有限公司厦门鹭江道证券营业部,4,2828.79,3,656.09,1,"湘潭电化,天山股份"
55,西南证券股份有限公司杭州庆春东路证券营业部,3,0.0,0,3103.74,3,"新兴铸管,海默科技,中源协和"
56,光大证券股份有限公司奉化南山路证券营业部,1,0.0,0,792.56,1,锦龙股份
57,国泰君安证券股份有限公司宁波君子街证券营业部,6,14848.67,3,17556.34,3,"天山股份,青龙管业,恒泰艾普"
58,中信证券股份有限公司上海古北路证券营业部,36,74964.55,21,63431.08,15,"冀东装备,嘉寓股份,华斯股份,"
59,恒泰证券股份有限公司重庆泰山大道证券营业部,1,0.0,0,1877.33,1,新兴铸管
60,国都证券股份有限公司上海华山路证券营业部,2,0.0,0,315.97,2,"金陵体育,锦龙股份"
61,中泰证券股份有限公司深圳欢乐海岸证券营业部,3,1438.22,1,10467.22,2,"八一钢铁,茂业商业,冀东装备"
62,中信证券股份有限公司杭州延安路证券营业部,4,3101.51,1,2009.41,3,"中化岩土,新兴铸管,德艺文创,"
63,中国银河证券股份有限公司南京洪武路证券营业部,1,0.0,0,272.25,1,锦龙股份
64,华泰证券股份有限公司上海徐汇区天钥桥路证券营业部,11,14082.69,5,23600.8,6,"天山股份,吴江银行,新宏泽,"
65,中信证券股份有限公司深圳总部证券营业部,2,2136.03,1,8564.07,1,"锦龙股份,冀东装备"
66,中国中投证券有限责任公司南昌叠山路证券营业部,3,2048.96,2,1527.39,1,"石化机械,新兴铸管"
67,平安证券股份有限公司北京东花市证券营业部,13,7476.39,9,2697.68,4,"冀东装备,天山股份,西部建设,"
68,华泰证券股份有限公司上海共和新路证券营业部,7,2597.23,2,13900.23,5,"天山股份,钧达股份,恒立实业,"
69,中国银河证券股份有限公司重庆民族路证券营业部,4,9627.19,3,3449.7,1,"八一钢铁,中油工程,天山股份"
70,华泰证券股份有限公司南京中山北路第二证券营业部,6,5454.27,3,10133.35,3,"嘉寓股份,冀东装备,科林电气,"
71,申万宏源证券有限公司九江九瑞大道证券营业部,3,5667.66,1,12377.55,2,麦达数字
72,首创证券有限责任公司成都府城大道证券营业部,2,7256.53,2,0.0,0,麦达数字
73,广发证券股份有限公司秦皇岛和平大街证券营业部,4,5473.82,2,1096.29,2,"麦达数字,东方中科,迪贝电气"
74,中信证券股份有限公司福建分公司,2,3144.82,2,0.0,0,"麦达数字,东方中科"
75,财通证券股份有限公司丽水北苑路证券营业部,2,4431.81,2,0.0,0,麦达数字
76,中信证券股份有限公司温岭万昌中路证券营业部,2,0.0,0,4025.28,2,"湘潭电化,麦达数字"
77,东兴证券股份有限公司邵武五一九路证券营业部,12,9925.24,9,3416.3,3,"生意宝,太极实业,微光股份,"
78,东方证券股份有限公司桂林中山中路证券营业部,5,6689.14,3,1894.58,2,"雅百特,飞荣达,深圳华强,"
79,广发证券股份有限公司哈尔滨学府路证券营业部,2,0.0,0,1649.47,2,麦达数字
80,海通证券股份有限公司嘉兴中山西路证券营业部,2,3546.47,2,0.0,0,"河北宣工,东旭蓝天"
81,方正证券股份有限公司杭州延安路证券营业部,5,11202.56,2,9321.99,3,"天山股份,中化岩土,京汉股份"
82,华福证券有限责任公司漳浦朝阳路证券营业部,3,1173.3,1,1648.31,2,"河北宣工,永和智控"
83,广发证券股份有限公司广州中山三路中华广场证券营业部,3,1114.25,1,2083.51,2,河北宣工
84,西南证券股份有限公司兰州南昌路证券营业部,1,1998.64,1,0.0,0,麦达数字
85,中泰证券股份有限公司潍坊四平路证券营业部,1,0.0,0,2298.37,1,河北宣工
86,华泰证券股份有限公司绍兴府山证券营业部,7,4074.57,3,2349.59,4,"冀东水泥,坤彩科技,四通新材,"
87,方正证券股份有限公司杭州保俶路证券营业部,2,0.0,0,4674.64,2,"天山股份,韦尔股份"
88,中信证券股份有限公司杭州定安路证券营业部,2,0.0,0,913.73,2,"张家港行,麦达数字"
89,西藏东方财富证券股份有限公司拉萨金珠西路第二证券营业部,11,3598.2,5,2286.69,6,"周大生,青龙管业,河北宣工,"
90,光大证券股份有限公司慈溪观海卫证券营业部,6,10382.29,3,11794.72,3,"千方科技,京汉股份,韩建河山"
91,华泰证券股份有限公司舟山解放东路证券营业部,8,9196.88,6,2927.28,2,"中持股份,英洛华,三超新材,"
92,华泰证券股份有限公司上海浦东新区乳山路证券营业部,1,1493.1,1,0.0,0,千方科技
93,湘财证券股份有限公司上海金沙江路证券营业部,2,3865.61,2,0.0,0,"汉钟精机,千方科技"
94,中信建投证券股份有限公司北京丹棱街证券营业部,2,0.0,0,5378.55,2,千方科技
95,中航证券有限公司西安未央路证券营业部,1,0.0,0,890.81,1,千方科技
96,华宝证券有限责任公司深圳新闻路证券营业部,1,0.0,0,751.63,1,千方科技
97,中国银河证券股份有限公司北京黄寺大街证券营业部,2,0.0,0,6950.54,2,"易华录,千方科技"
98,五矿证券有限公司深圳金田路证券营业部,3,249.65,1,1526.51,2,"*ST东数,东方中科"
99,方正证券股份有限公司上海延安西路证券营业部,10,4541.8,6,2871.09,4,"茂业商业,力盛赛车,华灿光电,"
100,华泰证券股份有限公司汉川仙女大道证券营业部,1,9.3,1,0.0,0,*ST东数
101,长江证券股份有限公司武汉友谊大道证券营业部,1,492.97,1,0.0,0,雅百特
102,东吴证券股份有限公司上海分公司,3,278.78,2,73.45,1,"东方中科,*ST东数,雷曼股份"
103,中泰证券股份有限公司厦门鹭江道证券营业部,4,962.8,2,766.35,2,"升达林业,雅百特,光莆股份"
104,平安证券股份有限公司深圳深南东路罗湖商务中心证券营业部,29,9852.97,17,5295.99,12,"江阴银行,清源股份,西部建设,"
105,广发证券股份有限公司成都分公司,1,329.19,1,0.0,0,雅百特
106,中国中投证券有限责任公司江门迎宾大道证券营业部,1,0.0,0,77.83,1,*ST东数
107,银泰证券有限责任公司西安友谊西路证券营业部,2,3668.02,1,630.27,1,"光正集团,雅百特"
108,中国中投证券有限责任公司南通如东青园北路证券营业部,1,0.0,0,44.94,1,*ST东数
109,兴业证券股份有限公司北京西直门北大街证券营业部,2,0.0,0,844.02,2,"吉宏股份,雅百特"
110,中国中投证券有限责任公司无锡清扬路证券营业部,2,39.84,1,44.45,1,"新日股份,*ST东数"
111,中国银河证券股份有限公司台州证券营业部,3,7463.07,1,4192.59,2,青龙管业
112,中原证券股份有限公司郑州纬二路证券营业部,1,0.0,0,242.52,1,雅百特
113,渤海证券股份有限公司天津自贸区中心证券营业部,1,0.0,0,34.12,1,*ST东数
114,中信建投证券股份有限公司重庆涪陵广场路证券营业部,3,15887.48,3,0.0,0,"建新股份,青龙管业"
115,新时代证券股份有限公司上海武定路证券营业部,1,0.0,0,238.67,1,雅百特
116,申万宏源西部证券有限公司烟台大马路证券营业部,1,0.0,0,32.03,1,*ST东数
117,中信建投证券股份有限公司杭州庆春路证券营业部,2,7682.71,2,0.0,0,"青龙管业,陕西金叶"
118,平安证券股份有限公司上海分公司,11,2520.95,4,1713.12,7,"天山股份,大丰实业,中科创达,"
119,中信证券股份有限公司上海东方路证券营业部,3,6796.73,1,12107.0,2,"冀东装备,青龙管业"
120,中信证券股份有限公司杭州四季路证券营业部,16,20401.9,8,20634.44,8,"恒泰艾普,无锡银行,联泰环保,"
121,民生证券股份有限公司驻马店解放路证券营业部,4,3276.63,2,4064.25,2,"渤海股份,青龙管业"
122,华泰证券股份有限公司成都天府新区正东中街证券营业部,7,2944.68,4,2407.61,3,"永和智控,中油工程,濮阳惠成,"
123,平安证券股份有限公司深圳深南大道证券营业部,1,1192.89,1,0.0,0,东旭蓝天
124,申万宏源西部证券有限公司福州杨桥东路证券营业部,8,15966.91,4,19605.73,4,"无锡银行,江阴银行,东凌国际,"
125,华鑫证券有限责任公司上海自贸试验区分公司,3,663.38,1,1431.76,2,永和智控
126,东莞证券股份有限公司成都东大街证券营业部,2,2502.45,2,0.0,0,"华斯股份,东旭蓝天"
127,海通证券股份有限公司宁波百丈东路证券营业部,1,2480.51,1,0.0,0,江阴银行
128,华泰证券股份有限公司苏州何山路证券营业部,2,1321.8,2,0.0,0,"巨力索具,永和智控"
129,招商证券股份有限公司上海陆家嘴东路证券营业部,1,799.14,1,0.0,0,东旭蓝天
130,华福证券有限责任公司泉州丰泽街证券营业部,4,3620.71,2,3427.07,2,"中化岩土,*ST鲁丰"
131,海通证券股份有限公司杭州解放路证券营业部,11,16315.32,8,4966.68,3,"无锡银行,江阴银行,海虹控股,"
132,华泰证券股份有限公司合肥创新大道证券营业部,1,359.05,1,0.0,0,永和智控
133,华泰证券股份有限公司上海分公司,5,3895.35,3,4007.7,2,"科林电气,东旭蓝天,禾丰牧业"
134,海通证券股份有限公司上海共和新路证券营业部,1,2640.02,1,0.0,0,中化岩土
135,民生证券股份有限公司福州华林路证券营业部,1,2060.36,1,0.0,0,江阴银行
136,中信证券股份有限公司台州府中路证券营业部,2,0.0,0,1815.46,2,永和智控
137,华福证券有限责任公司深圳市深南大道证券营业部,4,2739.28,2,2321.41,2,"坤彩科技,*ST鲁丰,东旭蓝天,"
138,中信证券股份有限公司深圳深南中路中信大厦证券营业部,1,1671.85,1,0.0,0,江阴银行
139,华福证券有限责任公司厦门湖滨南路证券营业部,9,7263.56,5,9333.92,4,"中化岩土,海虹控股,吴江银行,"
140,国泰君安证券股份有限公司北京知春路证券营业部,3,9.53,1,1842.66,2,"永和智控,莱茵体育,*ST东数"
141,中国中投证券有限责任公司宁波江东北路证券营业部,6,16021.23,4,4435.44,2,"八一钢铁,横河模具,陇神戎发,"
142,国盛证券有限责任公司南昌永叔路证券营业部,1,0.0,0,4569.78,1,中化岩土
143,中信证券股份有限公司慈溪慈甬路证券营业部,3,0.0,0,10640.48,3,"江阴银行,无锡银行"
144,光大证券股份有限公司长春解放大路证券营业部,1,0.0,0,423.56,1,永和智控
145,华鑫证券有限责任公司上海嘉定棋盘路证券营业部,3,216.41,1,3316.69,2,"三超新材,江阴银行"
146,海通证券股份有限公司福州群众路证券营业部,4,435.13,3,357.17,1,"仰帆控股,新日股份,永和智控"
147,国泰君安证券股份有限公司上海四平路证券营业部,1,0.0,0,3709.41,1,中化岩土
148,中原证券股份有限公司上海第一分公司,2,1792.07,1,2667.46,1,"无锡银行,江阴银行"
149,长江证券股份有限公司台州市府大道证券营业部,1,0.0,0,2620.12,1,江阴银行
150,东海证券股份有限公司福建厦门分公司,1,27.54,1,0.0,0,传艺科技
151,广发证券股份有限公司吉林吉林大街证券营业部,1,0.0,0,2.03,1,传艺科技
152,中国银河证券股份有限公司兰溪三江路证券营业部,1,0.0,0,1.87,1,传艺科技
153,申万宏源证券有限公司上海闵行区东川路证券营业部,5,5810.33,2,11806.53,3,"力盛赛车,科林电气"
154,广发证券股份有限公司杭州密渡桥路证券营业部,1,876.6,1,0.0,0,东方中科
155,安信证券股份有限公司佛山三水三兴路证券营业部,2,0.0,0,2.82,2,"钧达股份,传艺科技"
156,海通证券股份有限公司丽水城东路证券营业部,3,398.03,1,6225.93,2,"东方中科,陇神戎发"
157,中国中投证券有限责任公司杭州环球中心证券营业部,17,12207.92,8,14497.61,9,"新宏泽,坤彩科技,透景生命,"
158,长城证券股份有限公司广州天河北路证券营业部,1,0.0,0,1.55,1,传艺科技
159,国信证券股份有限公司深圳振华路证券营业部,3,740.17,1,1206.01,2,新宏泽
160,华鑫证券有限责任公司苏州时代广场证券营业部,3,680.17,1,1447.11,2,"新宏泽,今飞凯达"
161,海通证券股份有限公司南京广州路证券营业部,10,8394.12,6,5699.61,4,"陇神戎发,浩丰科技,博天环境,"
162,长江证券股份有限公司上海徐汇区斜土路证券营业部,3,1389.5,2,697.61,1,新宏泽
163,安信证券股份有限公司清远佛冈证券营业部,1,0.0,0,898.85,1,东方中科
164,光大证券股份有限公司北京中关村证券营业部,1,0.0,0,1210.26,1,力盛赛车
165,金元证券股份有限公司丹东坝岗路证券营业部,1,0.0,0,773.28,1,东方中科
166,华泰证券股份有限公司上海静安区威海路证券营业部,1,0.0,0,1184.31,1,新宏泽
167,中信证券股份有限公司宁波天童北路证券营业部,3,1936.51,2,862.71,1,"吴江银行,新宏泽"
168,安信证券股份有限公司南昌胜利路证券营业部,2,4788.0,1,2.21,1,"银江股份,星云股份"
169,方正证券股份有限公司宁波解放北路证券营业部,4,2198.79,3,712.89,1,"银江股份,金石资源,奥翔药业,"
170,东方证券股份有限公司昆明白龙路证券营业部,1,0.0,0,6714.89,1,银江股份
171,华泰证券股份有限公司杭州解放东路证券营业部,2,497.98,1,1252.71,1,"新劲刚,银江股份"
172,东兴证券股份有限公司郑州商务外环路证券营业部,2,654.39,1,1063.62,1,"禾丰牧业,银江股份"
173,联讯证券股份有限公司南通工农路证券营业部,2,1471.42,1,731.55,1,"飞荣达,银江股份"
174,长城证券股份有限公司仙桃钱沟路证券营业部,6,7094.53,4,4316.74,2,"太空板业,建新股份,新宏泽,"
175,广发证券股份有限公司深圳民田路证券营业部,4,3217.24,1,6475.18,3,"建新股份,华斯股份"
176,广发证券股份有限公司泉州涂门街证券营业部,3,2668.68,2,1734.84,1,"建新股份,恒泰艾普,博云新材"
177,兴业证券股份有限公司福州湖东路证券营业部,6,3333.02,4,5894.45,2,"嘉寓股份,永和智控,浩云科技,"
178,中信证券股份有限公司义乌城中中路证券营业部,2,209.2,1,1037.73,1,"升达林业,建新股份"
179,中国中投证券有限责任公司北京宋庄路证券营业部,2,0.0,0,1823.63,2,"建新股份,星云股份"
180,华西证券股份有限公司宜宾北正街证券营业部,1,0.0,0,517.12,1,建新股份
181,华泰证券股份有限公司深圳益田路荣超商务中心证券营业部,22,23194.86,12,15835.86,10,"龙溪股份,津膜科技,透景生命,"
182,安信证券股份有限公司茂名人民南路证券营业部,1,0.0,0,496.43,1,建新股份
183,华泰证券股份有限公司南京中山北路证券营业部,6,5787.31,3,1605.49,3,"先河环保,中化岩土,星云股份,"
184,中泰证券股份有限公司上海建国中路证券营业部,2,4739.98,2,0.0,0,"先河环保,华灿光电"
185,华泰证券股份有限公司成都蜀金路证券营业部,4,3466.44,2,886.0,2,"先河环保,飞凯材料,深圳华强,"
186,国联证券股份有限公司无锡五爱北路证券营业部,2,2561.95,1,7193.25,1,"吴江银行,先河环保"
187,中信证券股份有限公司上海联洋证券营业部,4,4184.33,1,11298.55,3,"冀东装备,先河环保,陇神戎发"
188,方正证券股份有限公司重庆新南路证券营业部,1,0.0,0,3328.13,1,先河环保
189,长江证券股份有限公司佛山普澜二路证券营业部,6,16317.22,3,9866.88,3,"京汉股份,恒泰艾普"
190,国泰君安证券股份有限公司宁波彩虹北路证券营业部,2,2454.37,1,2438.86,1,"恒泰艾普,汉钟精机"
191,中原证券股份有限公司郑州紫荆山路证券营业部,1,0.0,0,2038.86,1,恒泰艾普
192,华泰证券股份有限公司广州云城西路证券营业部,1,0.0,0,1752.91,1,恒泰艾普
193,长城证券股份有限公司如皋福寿路证券营业部,1,0.0,0,1718.29,1,恒泰艾普
194,渤海证券股份有限公司苏州景德路证券营业部,4,1275.15,1,3661.92,3,"国际医学,太空板业,中房地产,"
195,信达证券股份有限公司辽阳武圣路证券营业部,1,11.05,1,0.0,0,友讯达
196,广发证券股份有限公司杭州凤起路证券营业部,2,0.0,0,324.09,2,"德艺文创,友讯达"
197,国泰君安证券股份有限公司重庆民生路证券营业部,2,0.48,1,0.98,1,"金能科技,友讯达"
198,华泰证券股份有限公司天津白堤路证券营业部,1,0.0,0,0.98,1,友讯达
199,国信证券股份有限公司福州五一中路证券营业部,3,289.78,2,4.7,1,"电科院,金陵体育,恒润股份"
200,华泰证券股份有限公司银川新华西街证券营业部,2,0.0,0,172.17,2,"三德科技,友讯达"
201,方正证券股份有限公司成都高升桥路证券营业部,2,2721.9,2,0.0,0,四通新材
202,国联证券股份有限公司宜兴人民南路证券营业部,3,670.82,2,246.04,1,"电科院,德艺文创"
203,金元证券股份有限公司青岛银川西路证券营业部,1,228.12,1,0.0,0,电科院
204,中信证券股份有限公司浙江分公司,7,8564.31,7,0.0,0,"清源股份,浩丰科技,钧达股份,"
205,华泰证券股份有限公司深圳彩田路证券营业部,2,194.29,1,0.79,1,"电科院,杭州园林"
206,中银国际证券有限责任公司成都人民中路证券营业部,4,3961.42,3,1794.73,1,"四通新材,英洛华,新易盛"
207,华泰证券股份有限公司南通通州人民路证券营业部,5,2753.21,2,3916.58,3,"四通新材,新易盛,京汉股份"
208,中信证券股份有限公司湖北分公司,11,18352.68,6,11171.1,5,"京汉股份,渤海股份,浩丰科技"
209,华鑫证券有限责任公司呼和浩特中山西路证券营业部,2,1452.0,1,1449.51,1,四通新材
210,国泰君安证券股份有限公司深圳蔡屋围金华街证券营业部,5,3117.19,3,3251.16,2,"陇神戎发,浩丰科技,星云股份,"
211,安信证券股份有限公司嘉兴纺工路证券营业部,2,0.0,0,1520.25,2,"电科院,升达林业"
212,海通证券股份有限公司深圳分公司海德三道证券营业部,2,0.0,0,1376.93,2,"四通新材,广和通"
213,海通证券股份有限公司福清清昌大道证券营业部,1,0.0,0,4497.37,1,浩丰科技
214,华泰证券股份有限公司连云港通灌南路证券营业部,1,0.0,0,518.17,1,电科院
215,安信证券股份有限公司广州新港西路证券营业部,2,0.0,0,1293.99,2,"四通新材,优博讯"
216,中国中投证券有限责任公司广州体育东路证券营业部,3,6624.92,2,3419.77,1,"千方科技,浩丰科技"
217,国金证券股份有限公司成都双元街证券营业部,1,0.0,0,329.03,1,电科院
218,国盛证券有限责任公司吉安遂川工农兵大道证券营业部,1,0.0,0,652.08,1,四通新材
219,中泰证券股份有限公司武汉宝丰路证券营业部,2,1190.13,1,1954.82,1,"周大生,浩丰科技"
220,中信建投证券股份有限公司泸州迎晖路证券营业部,1,0.0,0,641.67,1,四通新材
221,中信建投证券股份有限公司北京北辰西路证券营业部,1,0.0,0,1771.99,1,浩丰科技
222,光大证券股份有限公司惠州麦地路证券营业部（迁址）,3,574.25,1,633.47,2,"四通新材,伟隆股份"
223,华泰证券股份有限公司无锡解放西路证券营业部,4,5015.93,2,5446.22,2,"长川科技,三星新材"
224,长江证券股份有限公司武汉武珞路证券营业部,6,3201.4,2,5186.62,4,"长川科技,正元智慧,吉宏股份,"
225,海通证券股份有限公司深圳分公司华富路证券营业部,10,6673.1,5,6934.38,5,"长川科技,陇神戎发,清源股份,"
226,光大证券股份有限公司佛山绿景路证券营业部,5,21591.98,4,244.32,1,"龙溪股份,泰山石油,雷曼股份,"
227,国信证券股份有限公司深圳泰然九路证券营业部,15,919.44,2,2749.82,13,"四通新材,周大生,*ST中基,"
228,长江证券股份有限公司成都天府大道证券营业部,2,1474.07,1,1388.39,1,德艺文创
229,联储证券有限责任公司厦门东港北路证券营业部,1,799.0,1,0.0,0,德艺文创
230,浙商证券股份有限公司江苏分公司,2,841.87,1,847.37,1,新劲刚
231,广发证券股份有限公司深圳深南东路证券营业部,8,6536.6,6,1058.25,2,"联泰环保,康惠制药,德艺文创,"
232,海通证券股份有限公司常州健身路证券营业部,4,1050.06,2,863.36,2,"新劲刚,恒通科技,强力新材"
233,华泰证券股份有限公司南京广州路证券营业部,2,1201.62,2,0.0,0,"江阴银行,新劲刚"
234,华鑫证券有限责任公司西安群贤路证券营业部,1,0.0,0,425.49,1,德艺文创
235,国金证券股份有限公司上海互联网证券分公司,23,8237.07,10,3753.6,13,"冀东装备,八一钢铁,联泰环保,"
236,安信证券股份有限公司厦门湖里大道证券营业部,2,384.44,1,299.08,1,"新劲刚,恒润股份"
237,中国中投证券有限责任公司娄底冷水江江北路证券营业部,1,0.0,0,855.04,1,新劲刚
238,财通证券股份有限公司义乌丹溪北路证券营业部,3,1342.52,2,270.05,1,"广和通,光莆股份"
239,中信证券股份有限公司北京安外大街证券营业部,6,3074.9,3,2203.44,3,"诚意药业,新宏泽,恒立实业,"
240,东方证券股份有限公司上海浦东新区耀华路证券营业部,2,751.77,1,734.92,1,广和通
241,方正证券股份有限公司杭州滨江通和路证券营业部,1,0.0,0,474.71,1,新劲刚
242,方正证券股份有限公司冷水江锑都中路证券营业部,1,0.0,0,471.28,1,新劲刚
243,光大证券股份有限公司深圳海德二路证券营业部,1,420.92,1,0.0,0,广和通
244,广发证券股份有限公司中山兴中道证券营业部,2,953.89,1,465.93,1,"中持股份,新劲刚"
245,中原证券股份有限公司北京酒仙桥路证券营业部,1,259.33,1,0.0,0,广和通
246,华泰证券股份有限公司沈阳大西路证券营业部,2,2.89,1,755.79,1,"广和通,韦尔股份"
247,广发证券股份有限公司上海控江路证券营业部,2,0.0,0,990.69,2,"广和通,今飞凯达"
248,招商证券股份有限公司上海娄山关路证券营业部,7,288.67,2,2515.31,5,"新劲刚,超频三,广和通,"
249,长江证券股份有限公司惠州下埔路证券营业部,6,12072.16,3,8208.45,3,"透景生命,华斯股份,渤海股份,"
250,兴业证券股份有限公司厦门湖滨南路证券营业部,4,6345.72,2,3131.04,2,"透景生命,吴江银行,巨力索具"
251,华鑫证券有限责任公司长沙芙蓉中路证券营业部,7,6667.99,5,2833.81,2,"透景生命,今飞凯达,三星新材"
252,华鑫证券有限责任公司深圳益田路证券营业部,2,246.45,1,641.84,1,"升达林业,透景生命"
253,宏信证券有限责任公司上海中华新路证券营业部,2,83.46,1,544.34,1,"绿康生化,透景生命"
254,国泰君安证券股份有限公司重庆九尺坎证券营业部,1,0.0,0,267.22,1,透景生命
255,湘财证券股份有限公司北京朝外大街证券营业部,1,138.1,1,0.0,0,龙溪股份
256,长城国瑞证券有限公司厦门莲前西路证券营业部,1,103.16,1,0.0,0,龙溪股份
257,申万宏源西部证券有限公司阿克苏东大街证券营业部,1,4282.75,1,0.0,0,中源协和
258,国信证券股份有限公司广州新港西路证券营业部,1,69.05,1,0.0,0,龙溪股份
259,西藏东方财富证券股份有限公司北京建国路证券营业部,1,3927.94,1,0.0,0,中源协和
260,华泰证券股份有限公司岳阳五里牌证券营业部,1,55.24,1,0.0,0,龙溪股份
261,中信建投证券股份有限公司潮州市潮枫路证券营业部,1,482.4,1,0.0,0,中源协和
262,西藏东方财富证券股份有限公司厦门莲岳路证券营业部,1,54.69,1,0.0,0,龙溪股份
263,中银国际证券有限责任公司广州天河路证券营业部,1,418.96,1,0.0,0,中源协和
264,国泰君安证券股份有限公司上海虹口区大连路证券营业部,1,644.2,1,0.0,0,兰石重装
265,长江证券股份有限公司武汉龙阳大道证券营业部,1,0.0,0,860.23,1,龙溪股份
266,东海证券股份有限公司溧阳南大街证券营业部,1,402.8,1,0.0,0,中源协和
267,太平洋证券股份有限公司曲靖麒麟南路证券营业部,1,617.03,1,0.0,0,兰石重装
268,安信证券股份有限公司上海杨高南路证券营业部,1,0.0,0,572.98,1,龙溪股份
269,中信建投证券股份有限公司北京安立路证券营业部,2,581.18,1,3902.65,1,"今飞凯达,中源协和"
270,兴业证券股份有限公司陕西分公司,6,7062.74,5,3199.99,1,"八一钢铁,陇神戎发,金能科技"
271,华泰证券股份有限公司南通人民中路证券营业部,6,1766.49,4,899.65,2,"新宏泽,兰石重装,陇神戎发,"
272,中国银河证券股份有限公司广州天河北路证券营业部,1,708.56,1,0.0,0,禾丰牧业
273,长城国瑞证券有限公司杭州新塘路证券营业部,1,0.0,0,552.4,1,龙溪股份
274,华福证券有限责任公司石狮金林路证券营业部,1,0.0,0,3060.02,1,中源协和
275,国元证券股份有限公司上海虹桥路证券营业部,9,7722.77,3,18387.34,6,"八一钢铁,冀东装备,恒泰艾普,"
276,中国银河证券股份有限公司北京广渠门大街证券营业部,2,575.08,1,3.11,1,"兰石重装,新日股份"
277,大通证券股份有限公司杭州古墩路证券营业部,1,0.0,0,251.2,1,龙溪股份
278,第一创业证券股份有限公司廊坊建设路证券营业部,2,377.71,1,860.84,1,"大晟文化,中源协和"
279,光大证券股份有限公司宁波中山西路证券营业部,2,2115.97,2,0.0,0,"八一钢铁,第一创业"
280,长江证券股份有限公司上海绵绣路证券营业部,3,1853.73,1,2490.37,2,"太空板业,中源协和"
281,浙商证券股份有限公司淳安明珠路证券营业部,1,0.0,0,207.43,1,龙溪股份
282,中信证券股份有限公司武汉建设大道证券营业部,1,434.98,1,0.0,0,禾丰牧业
283,中国中投证券有限责任公司广州天河路证券营业部,4,1124.54,1,4035.37,3,"兰石重装,茂业商业"
284,国信证券股份有限公司深圳红岭中路证券营业部,8,8941.53,6,14532.18,2,"海虹控股,力盛赛车,兔宝宝,"
285,招商证券股份有限公司广州天河北路证券营业部,2,0.0,0,677.02,2,"迪贝电气,禾丰牧业"
286,湘财证券股份有限公司佛山祖庙路证券营业部,3,1119.14,2,1220.84,1,"兰石重装,迪贝电气"
287,中信证券股份有限公司深圳深南大道证券营业部,3,445.5,1,3789.21,2,"红太阳,太空板业,八一钢铁"
288,中信建投证券股份有限公司福清田乾路证券营业部,2,0.0,0,753.8,2,兰石重装
289,华福证券有限责任公司福州金环路证券营业部,2,0.0,0,626.34,2,兰石重装
290,恒泰证券股份有限公司上海杜鹃路证券营业部,9,10457.17,7,2756.52,2,"八一钢铁,南宁百货,迪贝电气,"
291,中国国际金融股份有限公司上海黄浦区湖滨路证券营业部,3,0.0,0,6777.41,3,"北新路桥,航发动力,禾丰牧业"
292,西藏东方财富证券股份有限公司上海东方路证券营业部,8,11772.67,4,8813.15,4,"陇神戎发,八一钢铁,大晟文化,"
293,华泰证券股份有限公司杭州求是路证券营业部,7,2976.93,2,5093.13,5,"茂业商业,华灿光电,陇神戎发,"
294,湘财证券股份有限公司上海张杨路证券营业部,5,3003.75,3,639.65,2,"茂业商业,三超新材,陕西金叶"
295,天风证券股份有限公司客户资产管理部,2,2055.72,1,1820.97,1,茂业商业
296,世纪证券有限责任公司南昌阳明路证券营业部,2,1066.79,1,1251.66,1,茂业商业
297,中国中投证券有限责任公司广州番禺桥南路证券营业部,1,0.0,0,4266.49,1,茂业商业
298,广发证券股份有限公司广州花城大道证券营业部,1,764.55,1,0.0,0,瑞斯康达
299,方正证券股份有限公司温州小南路证券营业部,7,8204.04,3,7619.16,4,"无锡银行,吴江银行,江阴银行,"
300,华泰证券股份有限公司长沙韶山北路证券营业部,1,0.0,0,2198.8,1,茂业商业
301,中信建投证券股份有限公司北京市马家堡西路证券营业部,1,639.29,1,0.0,0,瑞斯康达
302,中国中投证券有限责任公司湛江百园路证券营业部,4,2540.23,2,1704.31,2,"太空板业,博天环境,万通智控,"
303,华福证券有限责任公司泉州丰泽街第二证券营业部,3,2556.05,2,2511.33,1,吴江银行
304,中国中投证券有限责任公司广州花都凤凰北路证券营业部,1,0.0,0,1674.24,1,茂业商业
305,西藏东方财富证券股份有限公司昌都聚盛路证券营业部,5,1700.8,2,2.47,3,"周大生,瑞斯康达,第一创业,"
306,湘财证券股份有限公司台州祥和路证券营业部,1,1095.09,1,0.0,0,吴江银行
307,新时代证券股份有限公司三门峡崤山路证券营业部,2,2793.83,1,3034.26,1,"柳钢股份,吴江银行"
308,华泰证券股份有限公司常州新北区高新科技园证券营业部,4,5282.39,2,9342.43,2,"坤彩科技,濮阳惠成,瑞斯康达"
309,南京证券股份有限公司张家港步行街证券营业部,3,3926.18,1,7829.01,2,联泰环保
310,招商证券股份有限公司柳州解放北路证券营业部,2,0.0,0,2417.46,2,"博天环境,吴江银行"
311,海通证券股份有限公司北京中关村南大街证券营业部,9,3086.99,3,11894.6,6,"清源股份,天山股份,陇神戎发,"
312,招商证券股份有限公司深圳益田路免税商务大厦证券营业部,5,2249.19,2,2390.21,3,"易华录,航天机电,吴江银行,"
313,中国银河证券股份有限公司成都科华北路证券营业部,5,2182.82,2,5211.5,3,"中持股份,可立克,银龙股份,"
314,湘财证券股份有限公司上海陆家嘴证券营业部,11,7000.15,3,13480.25,8,"韩建河山,联泰环保,张家港行,"
315,兴业证券股份有限公司厦门兴隆路证券营业部,2,875.75,1,1281.01,1,"柳钢股份,吴江银行"
316,华泰证券股份有限公司太原体育路证券营业部,2,0.0,0,2221.01,2,"新劲刚,瑞斯康达"
317,长江证券股份有限公司厦门湖滨北路证券营业部,2,3280.74,1,1182.26,1,"柳钢股份,吴江银行"
318,安信证券股份有限公司梅州新中路证券营业部,4,1649.7,2,1744.71,2,"正虹科技,中持股份,乐心医疗,"
319,华泰证券股份有限公司湖北分公司,1,0.0,0,889.77,1,联泰环保
320,国泰君安证券股份有限公司徐州解放路证券营业部,4,2.86,1,1348.0,3,"韦尔股份,金石资源,联泰环保"
321,安信证券股份有限公司上海世纪大道证券营业部,1,15.12,1,0.0,0,韦尔股份
322,浙商证券股份有限公司永康九铃东路证券营业部,2,1102.3,1,1.01,1,"巨力索具,韦尔股份"
323,东北证券股份有限公司江阴滨江东路证券营业部,1,1359.17,1,0.0,0,清源股份
324,中邮证券有限责任公司西安阎良人民路证券营业部,1,0.0,0,1.01,1,韦尔股份
325,山西证券股份有限公司汾阳汾酒厂证券营业部,1,0.0,0,1.01,1,韦尔股份
326,中原证券股份有限公司青岛仙霞岭路证券营业部,3,1799.43,1,3042.69,2,"西部资源,清源股份"
327,中国银河证券股份有限公司重庆沙南街证券营业部,2,1673.18,1,1242.29,1,清源股份
328,浙商证券股份有限公司杭州萧山恒隆广场证券营业部,2,0.0,0,2049.94,2,"共达电声,清源股份"
329,中国银河证券股份有限公司宁波大庆南路证券营业部,2,3088.33,2,0.0,0,"八一钢铁,全信股份"
330,华泰证券股份有限公司海门解放中路证券营业部,2,1650.18,2,0.0,0,"康惠制药,江阴银行"
331,招商证券股份有限公司深圳深南大道车公庙证券营业部,3,1703.99,2,1313.8,1,"康惠制药,中油工程,长川科技"
332,招商证券股份有限公司北京安外大街证券营业部,1,0.0,0,2013.13,1,八一钢铁
333,西藏东方财富证券股份有限公司山南乃东县湖南路证券营业部,3,1340.79,3,0.0,0,"正元智慧,康惠制药,海默科技"
334,申万宏源证券有限公司武汉青年路证券营业部,5,7934.68,3,5742.72,2,"八一钢铁,中成股份"
335,东方证券股份有限公司厦门仙岳路证券营业部,4,3399.21,1,7900.66,3,"坤彩科技,乐心医疗,中房地产"
336,广发证券股份有限公司成都新光路证券营业部,2,403.56,1,780.78,1,"佳讯飞鸿,康惠制药"
337,中国银河证券股份有限公司杭州天城东路证券营业部,5,6906.12,4,2318.93,1,"坤彩科技,中持股份,渤海股份,"
338,华宝证券有限责任公司上海自贸区证券营业部,1,0.0,0,541.12,1,康惠制药
339,中国银河证券股份有限公司北京金融街证券营业部,3,0.0,0,1018.07,3,"中泰桥梁,格尔软件,康惠制药"
340,广发证券股份有限公司广州环市东路证券营业部,1,0.0,0,2727.25,1,坤彩科技
341,浙商证券股份有限公司临安万马路证券营业部,4,4923.04,2,5164.62,2,"银龙股份,渤海股份,坤彩科技"
342,华泰证券股份有限公司台州中心大道证券营业部,1,0.0,0,2464.14,1,坤彩科技
343,海通证券股份有限公司蚌埠中荣街证券营业部,6,5332.4,2,11443.88,4,"张家港行,清源股份,川润股份,"
344,五矿证券有限公司北京将台路证券营业部,1,0.0,0,2705.26,1,清源股份
345,华鑫证券有限责任公司上海宛平南路证券营业部,2,1314.71,1,1508.58,1,科林电气
346,华泰证券股份有限公司上海浦东新区福山路证券营业部,6,2799.55,4,2445.28,2,"科林电气,长川科技,力盛赛车,"
347,中信证券股份有限公司上海恒丰路证券营业部,4,2055.02,3,413.77,1,"传艺科技,吉宏股份,新日股份,"
348,湘财证券股份有限公司上海泰兴路证券营业部,2,1093.2,1,1231.05,1,科林电气
349,海通证券股份有限公司上海嘉定区福海路证券营业部,1,7.08,1,0.0,0,迪贝电气
350,长江证券股份有限公司武汉中北路证券营业部,1,7.48,1,0.0,0,新日股份
351,安信证券股份有限公司潮州城新西路证券营业部,1,0.0,0,1.73,1,迪贝电气
352,国泰君安证券股份有限公司衡阳雁城路证券营业部,4,0.0,0,362.79,4,"全信股份,友讯达,星云股份,"
353,广发证券股份有限公司乌鲁木齐北京南路证券营业部,1,0.0,0,1.73,1,迪贝电气
354,国信证券股份有限公司上海北京东路证券营业部,13,2338.61,5,2025.88,8,"西部建设,钧达股份,乐心医疗,"
355,广发证券股份有限公司宜昌东山大道证券营业部,1,0.0,0,1.73,1,迪贝电气
356,长城证券股份有限公司前海分公司,2,1060.36,1,1.29,1,"吴江银行,新日股份"
357,财富证券有限责任公司上海大连路证券营业部,1,0.0,0,38.02,1,科林电气
358,西南证券股份有限公司武汉中北路证券营业部,1,0.0,0,1.73,1,迪贝电气
359,招商证券股份有限公司深圳前海路证券营业部,4,2726.47,2,3.78,2,"新劲刚,太龙照明,新日股份"
360,中信证券股份有限公司杭州市心南路证券营业部,8,5904.6,6,720.43,2,"华建集团,中化岩土,钧达股份,"
361,平安证券股份有限公司深圳商报路奥林匹克大厦证券营业部,3,0.0,0,4.86,3,"鸣志电器,新日股份"
362,东海证券股份有限公司上海虹口区中山北一路证券营业部,1,882.08,1,0.0,0,诚意药业
363,东方证券股份有限公司上海徐汇区肇嘉浜路证券营业部,4,809.7,1,9946.79,3,"诚意药业,国际医学"
364,大通证券股份有限公司上海南车站路证券营业部,2,4890.28,2,0.0,0,"银河生物,诚意药业"
365,申万宏源证券有限公司上海浦东新区陆家嘴环路证券营业部,2,545.39,1,2748.67,1,诚意药业
366,九州证券股份有限公司上海分公司,1,0.0,0,3691.68,1,诚意药业
367,万和证券股份有限公司成都蜀汉路证券营业部,3,4707.93,3,0.0,0,"冀东装备,三星新材,透景生命"
368,东方证券股份有限公司上海黄浦区中华路证券营业部,1,0.0,0,3399.76,1,诚意药业
369,申万宏源证券有限公司上海崇明县川心街证券营业部,2,0.0,0,5121.14,2,"三星新材,诚意药业"
370,中信证券股份有限公司广州临江大道证券营业部,2,639.76,1,6822.99,1,"三星新材,光正集团"
371,中信证券股份有限公司上海长寿路证券营业部,2,4872.54,1,2235.36,1,"银河生物,三星新材"
372,爱建证券有限责任公司杭州富春路证券营业部,1,0.0,0,1796.67,1,三星新材
373,爱建证券有限责任公司上海世纪大道证券营业部,2,5579.81,1,1507.86,1,"银河生物,三星新材"
374,财通证券股份有限公司永康九铃东路证券营业部,1,0.0,0,1462.6,1,三星新材
375,方正证券股份有限公司金华光南路证券营业部,1,6845.13,1,0.0,0,京汉股份
376,国泰君安证券股份有限公司石家庄建华南大街证券营业部,2,154.39,1,489.35,1,"恒立实业,四通新材"
377,华泰证券股份有限公司上海浦东新区妙境路证券营业部,2,2572.61,2,0.0,0,"渤海股份,优博讯"
378,国泰君安证券股份有限公司连云港巨龙南路证券营业部,1,142.14,1,0.0,0,恒立实业
379,申万宏源证券有限公司嘉善体育南路证券营业部,1,1863.13,1,0.0,0,锦龙股份
380,华泰证券股份有限公司青岛宁夏路证券营业部,14,15182.97,10,7673.37,4,"渤海股份,汉钟精机,横店东磁,"
381,中信证券股份有限公司上海瑞金南路证券营业部,4,2133.2,1,12816.04,3,"长川科技,陇神戎发,韩建河山,"
382,中国中投证券有限责任公司扬州邗江北路证券营业部,4,0.0,0,4876.71,4,"恒立实业,瀛通通讯,嘉寓股份,"
383,天风证券股份有限公司成都双成三路证券营业部,3,886.28,1,1223.56,2,"濮阳惠成,恒立实业"
384,国泰君安证券股份有限公司深圳益田路证券营业部,7,6224.48,5,5229.69,2,"北京科锐,河北宣工,锦龙股份,"
385,华泰证券股份有限公司常州和平北路证券营业部,2,189.6,1,2098.05,1,"渤海股份,南方轴承"
386,中信建投证券股份有限公司上海青浦证券营业部,1,0.0,0,248.85,1,恒立实业
387,中信建投证券股份有限公司济南经四路证券营业部,1,0.0,0,230.24,1,恒立实业
388,中国中投证券有限责任公司广汉韶山路证券营业部,1,0.0,0,3240.69,1,锦龙股份
389,西部证券股份有限公司西安高新技术产业开发区证券营业部,2,0.0,0,2150.09,2,"京汉股份,国际医学"
390,华泰证券股份有限公司上海奉贤区望园南路证券营业部,1,0.0,0,1776.76,1,渤海股份
391,中信建投证券股份有限公司太原新建路证券营业部,2,0.0,0,485.61,2,"乐心医疗,恒立实业"
392,华泰证券股份有限公司扬州文昌中路证券营业部,1,1355.38,1,0.0,0,华东科技
393,安信证券股份有限公司汕头中山路证券营业部,2,1869.35,2,0.0,0,中房地产
394,民生证券股份有限公司长沙晚报大道证券营业部,3,2059.71,2,496.88,1,"浩丰科技,华东科技"
395,海通证券股份有限公司汕头中山中路证券营业部,1,703.11,1,0.0,0,中房地产
396,英大证券有限责任公司深圳前海路证券营业部,1,762.1,1,0.0,0,华东科技
397,光大证券股份有限公司海口国贸大道证券营业部,5,1807.11,5,0.0,0,"中房地产,中钢国际,共达电声,"
398,国元证券股份有限公司佛山季华五路证券营业部,2,2332.87,1,1253.6,1,中房地产
399,中信建投证券股份有限公司深圳深南中路中核大厦证券营业部,1,410.72,1,0.0,0,中房地产
400,国海证券股份有限公司桂林中山中路证券营业部,2,2476.94,2,0.0,0,"中房地产,陇神戎发"
401,海通证券股份有限公司深圳分公司红岭中路证券营业部,1,337.24,1,0.0,0,中房地产
402,长江证券股份有限公司武汉胜利街证券营业部,2,0.0,0,1847.18,2,"信邦制药,华东科技"
403,中国银河证券股份有限公司广州华夏路证券营业部,1,1050.46,1,0.0,0,中房地产
404,海通证券股份有限公司杭州文化路证券营业部,9,4348.91,6,1876.71,3,"北京科锐,长川科技,三超新材,"
405,中国银河证券股份有限公司广州滨江东路证券营业部,1,0.0,0,673.16,1,华东科技
406,安信证券股份有限公司梅州兴宁迎宾大道证券营业部,1,0.0,0,441.79,1,中房地产
407,海通证券股份有限公司宁波解放北路证券营业部,1,0.0,0,607.5,1,华东科技
408,华林证券股份有限公司深圳海秀路证券营业部,1,0.0,0,413.94,1,中房地产
409,国海证券股份有限公司济南历山路证券营业部,1,0.0,0,6933.6,1,中房地产
410,东海证券股份有限公司厦门祥福路证券营业部,1,0.0,0,5571.81,1,中房地产
411,华林证券股份有限公司拉萨柳梧新区察古大道证券营业部,1,0.0,0,5537.24,1,中房地产
412,中信证券股份有限公司绍兴兴越路证券营业部,2,2877.93,2,0.0,0,"冀东装备,广和通"
413,广发证券股份有限公司北京鲁谷路证券营业部,1,5438.71,1,0.0,0,银泰资源
414,国泰君安证券股份有限公司北京金融街证券营业部,1,3966.0,1,0.0,0,银泰资源
415,长江证券股份有限公司上海黄兴路证券营业部,3,3537.62,2,1091.75,1,"银泰资源,京汉股份"
416,华泰证券股份有限公司南京长江路证券营业部,2,1641.94,1,2059.52,1,银泰资源
417,财通证券股份有限公司杭州环城西路证券营业部,1,383.11,1,0.0,0,银泰资源
418,国融证券股份有限公司赤峰玉龙大街证券营业部,1,0.0,0,4242.51,1,银泰资源
419,华龙证券股份有限公司新昌十九峰路证券营业部,1,0.0,0,437.05,1,银泰资源
420,国元证券股份有限公司淮南朝阳西路证券营业部,2,639.82,1,694.02,1,"博云新材,中成股份"
421,安信证券股份有限公司陕西分公司,1,464.53,1,0.0,0,博云新材
422,浙商证券股份有限公司金华后街证券营业部,2,3263.21,2,0.0,0,"冀东水泥,横店东磁"
423,海通证券股份有限公司上海余姚路证券营业部,1,0.0,0,2848.26,1,横店东磁
424,海通证券股份有限公司天津霞光道证券营业部,11,7700.89,7,6020.12,4,"中成股份,太空板业,生意宝,"
425,华宝证券有限责任公司舟山解放西路证券营业部,4,7149.9,3,4289.57,1,"华斯股份,银龙股份,中油工程"
426,中泰证券股份有限公司青岛凤凰山路证券营业部,1,0.0,0,633.26,1,博云新材
427,新时代证券股份有限公司深圳福华一路证券营业部,1,4140.28,1,0.0,0,光正集团
428,中泰证券股份有限公司潍坊滨海经济开发区海化街证券营业部,1,0.0,0,454.57,1,博云新材
429,国联证券股份有限公司海门长江南路证券营业部,1,3898.45,1,0.0,0,光正集团
430,中国银河证券股份有限公司金华证券营业部,3,0.0,0,886.23,3,"博云新材,微光股份,超频三"
431,浙商证券股份有限公司东阳新南路证券营业部,3,0.0,0,1933.65,3,"横店东磁,易事特,英洛华"
432,申万宏源证券有限公司上海嘉定区塔城路证券营业部,3,1023.8,2,5014.11,1,"中航黑豹,*ST东数,华斯股份"
433,华福证券有限责任公司连江丹凤东路证券营业部,2,2216.46,1,1616.37,1,"汉钟精机,华斯股份"
434,安信证券股分有限公司广州南沙进港大道证券营业部,1,2748.42,1,0.0,0,光正集团
435,信达证券股份有限公司温岭万昌中路证券营业部,1,2540.19,1,0.0,0,光正集团
436,湘财证券股份有限公司沈阳绥化西街证券营业部,1,0.0,0,1242.65,1,华斯股份
437,安信证券股份有限公司广州猎德大道证券营业部,2,1077.82,1,1169.93,1,华斯股份
438,招商证券股份有限公司武汉中北路证券营业部,1,0.0,0,2701.66,1,光正集团
439,中信建投证券股份有限公司慈溪三北西大街证券营业部,1,0.0,0,2370.87,1,光正集团
440,华鑫证券有限责任公司上海斜土路证券营业部,2,2925.34,1,1.96,1,"中化岩土,鸣志电器"
441,海通证券股份有限公司长沙五一大道证券营业部,4,3001.58,3,1118.45,1,"中化岩土,渤海股份,迪贝电气"
442,方正证券股份有限公司长沙五一东路证券营业部,1,1396.35,1,0.0,0,中化岩土
443,南京证券股份有限公司南京大钟亭证券营业部,3,2498.96,1,4834.77,2,"清源股份,中化岩土"
444,财通证券股份有限公司温岭中华路证券营业部,9,8992.3,6,6023.98,3,"永和智控,华建集团,无锡银行,"
445,兴业证券股份有限公司成都航空路证券营业部,1,634.62,1,0.0,0,永和智控
446,华泰证券股份有限公司南宁中泰路证券营业部,5,3943.81,3,4648.24,2,"江阴银行,渤海股份,河北宣工"
447,申万宏源证券有限公司南通青年中路证券营业部,2,0.0,0,1529.27,2,永和智控
448,华安证券股份有限公司北京中关村大街证券营业部,2,1553.32,2,0.0,0,"江阴银行,张家港行"
449,长江证券股份有限公司福州五一北路证券营业部,2,0.0,0,471.32,2,"永和智控,正元智慧"
450,中泰证券股份有限公司烟台环山路证券营业部,3,613.86,1,435.99,2,"易事特,永和智控,新日股份"
451,平安证券股份有限公司长沙五一大道证券营业部,1,1025.28,1,0.0,0,吉宏股份
452,华福证券有限责任公司晋江新华街证券营业部,3,0.0,0,10388.73,3,"江阴银行,海虹控股"
453,申万宏源西部证券有限公司乌鲁木齐和平北路证券营业部,1,794.28,1,0.0,0,吉宏股份
454,中信证券股份有限公司北京复外大街证券营业部,2,730.6,2,0.0,0,"吉宏股份,航天机电"
455,财通证券股份有限公司温州人民东路证券营业部,2,0.0,0,4237.6,2,"天山生物,江阴银行"
456,国盛证券有限责任公司赣州信丰阳明北路证券营业部,1,0.0,0,660.36,1,吉宏股份
457,中泰证券股份有限公司宁波北仑恒山路证券营业部,1,0.0,0,582.3,1,吉宏股份
458,申万宏源证券有限公司成都西一环路证券营业部,2,658.78,1,671.37,1,新宏泽
459,光大证券股份有限公司宁波孝闻街证券营业部,3,0.0,0,2362.34,3,"五洋科技,乐心医疗,新宏泽"
460,国泰君安证券股份有限公司广州东风中路证券营业部,1,3017.53,1,0.0,0,力盛赛车
461,华泰证券股份有限公司上海澳门路证券营业部,6,5348.59,4,1531.35,2,"正元智慧,力盛赛车,北部湾港,"
462,申万宏源证券有限公司上海黄浦区雁荡路证券营业部,1,249.98,1,0.0,0,瀛通通讯
463,财通证券股份有限公司常熟枫林路证券营业部,3,1549.68,2,1710.92,1,"力盛赛车,银之杰"
464,湘财证券股份有限公司长沙新民路证券营业部,1,1713.21,1,0.0,0,今飞凯达
465,大通证券股份有限公司新余仙来中大道证券营业部,1,240.05,1,0.0,0,瀛通通讯
466,华泰证券股份有限公司江西分公司,3,1393.19,2,724.93,1,力盛赛车
467,东方证券股份有限公司义乌宾王路证券营业部,9,5400.43,6,3423.48,3,"今飞凯达,钧达股份,传艺科技,"
468,国信证券股份有限公司成都二环路证券营业部,7,2802.26,4,3051.32,3,"传艺科技,今飞凯达,英洛华,"
469,东海证券股份有限公司洛阳周山路证券营业部,4,1265.17,1,2485.58,3,"力盛赛车,传艺科技"
470,华泰证券股份有限公司广州体育东路证券营业部,2,1217.44,2,0.0,0,今飞凯达
471,东海证券股份有限公司长沙韶山北路证券营业部,10,5893.69,7,1878.14,3,"今飞凯达,透景生命,正元智慧,"
472,中国银河证券股份有限公司上海安业路证券营业部,2,0.0,0,300.29,2,"瀛通通讯,友讯达"
473,海通证券股份有限公司上海玉田支路证券营业部,2,0.0,0,1454.68,2,力盛赛车
474,华鑫证券有限责任公司西安解放路证券营业部,2,521.65,1,932.72,1,"三超新材,今飞凯达"
475,大同证券有限责任公司衡阳解放大道证券营业部,2,111.46,1,122.61,1,钧达股份
476,国泰君安证券股份有限公司常州延陵中路证券营业部,2,0.0,0,505.57,2,"力盛赛车,传艺科技"
477,招商证券股份有限公司深圳科技园高新南一道证券营业部,4,45.12,3,2.53,1,"钧达股份,绿康生化,超频三,"
478,中信证券股份有限公司杭州凤起路证券营业部,2,1902.12,2,0.0,0,"北新路桥,钧达股份"
479,国信证券股份有限公司绵阳兴达街证券营业部,1,0.0,0,3.42,1,传艺科技
480,国泰君安证券股份有限公司南京太平南路证券营业部,3,904.76,1,943.54,2,"清源股份,钧达股份"
481,安信证券股份有限公司佛山南海大道证券营业部,1,0.0,0,1.27,1,钧达股份
482,国信证券股份有限公司深圳福中一路证券营业部,1,12.52,1,0.0,0,绿康生化
483,广发证券股份有限公司广州农林下路证券营业部,1,0.0,0,1.32,1,绿康生化
484,华泰证券股份有限公司上海长宁区仙霞路证券营业部,5,3072.53,2,3848.58,3,"汉钟精机,凤凰光学,钧达股份,"
485,华鑫证券有限责任公司上海莘庄证券营业部,1,0.0,0,1.32,1,绿康生化
486,兴业证券股份有限公司上海民生路证券营业部,3,206.45,1,261.16,2,"中葡股份,国际医学,绿康生化"
487,英大证券有限责任公司武汉汉阳大道证券营业部,1,706.44,1,0.0,0,天山生物
488,安信证券股份有限公司东莞常平大道证券营业部,1,491.73,1,0.0,0,天山生物
489,中国银河证券股份有限公司厦门虎园路证券营业部,1,222.57,1,0.0,0,天山生物
490,中国银河证券股份有限公司西宁长江路证券营业部,1,194.8,1,0.0,0,天山生物
491,中信证券股份有限公司上海漕溪北路证券营业部,6,10136.78,5,1296.26,1,"濮阳惠成,中成股份,津膜科技,"
492,招商证券股份有限公司沈阳惠工街证券营业部,3,1371.68,2,3206.33,1,"清源股份,微光股份,天山生物"
493,华鑫证券有限责任公司合肥梅山路证券营业部,1,2361.75,1,0.0,0,津膜科技
494,万联证券有限责任公司南京中山路证券营业部,2,2354.64,1,2727.35,1,津膜科技
495,中泰证券股份有限公司上海东方路证券营业部,1,0.0,0,844.05,1,天山生物
496,宏信证券有限责任公司成都红庙子街证券营业部,1,2134.65,1,0.0,0,津膜科技
497,长江证券股份有限公司上海番禺路证券营业部,1,0.0,0,418.08,1,天山生物
498,川财证券有限责任公司上海分公司,2,1746.61,2,0.0,0,"津膜科技,新日股份"
499,中山证券有限责任公司杭州杨公堤证券营业部,3,243.76,1,560.57,2,"佳讯飞鸿,正虹科技,天山生物"
500,中原证券股份有限公司许昌分公司,2,0.0,0,733.18,2,"太龙照明,津膜科技"
501,海通证券股份有限公司上海建国西路证券营业部,4,1431.29,2,1074.08,2,"银之杰,四通新材,华灿光电,"
502,广发证券股份有限公司武汉沿江大道证券营业部,2,0.0,0,550.61,2,"太龙照明,津膜科技"
503,中信建投证券股份有限公司张家港人民中路证券营业部,1,0.0,0,365.12,1,津膜科技
504,方正证券股份有限公司上海保定路证券营业部,8,4765.06,4,6445.84,4,"张家港行,新宏泽,新日股份,"
505,中国中投证券有限责任公司深圳深南大道证券营业部,10,9132.04,8,2025.23,2,"濮阳惠成,太极实业,新易盛,"
506,华泰证券股份有限公司无锡苏锡路证券营业部,1,566.69,1,0.0,0,新易盛
507,中国银河证券股份有限公司郑州经三路证券营业部,3,0.0,0,1472.85,3,"中持股份,飞凯材料,新易盛"
508,中国银河证券股份有限公司上海杨浦区靖宇东路证券营业部,4,0.0,0,31520.15,4,"新易盛,北京科锐"
509,上海证券有限责任公司青浦证券营业部,1,0.0,0,360.2,1,新易盛
510,山西证券股份有限公司宁波惊驾路证券营业部,1,0.0,0,346.12,1,新易盛
511,东北证券股份有限公司长春同志街第三证券营业部,1,0.0,0,270.15,1,新易盛
512,国信证券股份有限公司南昌八一大道证券营业部,1,1071.96,1,0.0,0,优博讯
513,财富证券有限责任公司南京新模范马路证券营业部,1,832.41,1,0.0,0,优博讯
514,大通证券股份有限公司上海高平路证券营业部,1,605.48,1,0.0,0,优博讯
515,中国银河证券股份有限公司浙江分公司,2,1199.35,2,0.0,0,"优博讯,微光股份"
516,中国民族证券有限责任公司哈尔滨东大直街证券营业部,2,1309.52,1,790.79,1,"中化岩土,优博讯"
517,广发证券股份有限公司温州瓯江路证券营业部,1,0.0,0,544.17,1,优博讯
518,东莞证券股份有限公司深圳新闻路证券营业部,2,1630.87,2,0.0,0,"渤海股份,三超新材"
519,世纪证券有限责任公司樟树富通街证券营业部,1,0.0,0,520.79,1,优博讯
520,安信证券股份有限公司广州滨江中路证券营业部,2,0.0,0,3.73,2,"友讯达,三超新材"
521,安信证券股份有限公司宜宾金沙江大道证券营业部,1,0.0,0,2.55,1,三超新材
522,安信证券股份有限公司玉林广场西路证券营业部,1,0.0,0,2.55,1,三超新材
523,财达证券股份有限公司佳木斯长安东路证券营业部,1,0.0,0,2.55,1,三超新材
524,长城证券股份有限公司北京西直门外大街证券营业部,1,0.0,0,2.55,1,三超新材
525,西南证券股份有限公司西宁五四大街证券营业部,1,1151.24,1,0.0,0,陇神戎发
526,国泰君安证券股份有限公司成都北一环路证券营业部,3,4485.15,3,0.0,0,"横河模具,三德科技,可立克"
527,华鑫证券有限责任公司深圳分公司,1,1221.31,1,0.0,0,横河模具
528,财达证券股份有限公司石家庄新华路证券营业部,3,1532.66,1,2150.35,2,陇神戎发
529,华泰证券股份有限公司成都晋阳路证券营业部,4,767.86,1,2940.95,3,"国际医学,新宏泽,佳讯飞鸿,"
530,中泰证券股份有限公司上海甘河路证券营业部,1,0.0,0,510.08,1,陇神戎发
531,华泰证券股份有限公司武汉中央商务区珠江路证券营业部,2,551.59,1,574.48,1,横河模具
532,方正证券股份有限公司永州南津中路证券营业部,1,0.0,0,1164.81,1,横河模具
533,恒泰证券股份有限公司上海龙华东路证券营业部,1,0.0,0,1018.24,1,横河模具
534,国泰君安证券股份有限公司郑州黄河路证券营业部,6,2242.77,2,3029.41,4,"钧达股份,太龙照明,横河模具"
535,安信证券股份有限公司武汉中北路证券营业部,3,0.0,0,1097.3,3,"金能科技,陇神戎发,横河模具"
536,广发证券股份有限公司深圳高新南一道证券营业部,1,515.8,1,0.0,0,熙菱信息
537,新时代证券股份有限公司包头广场西道证券营业部,1,389.76,1,0.0,0,熙菱信息
538,长城证券股份有限公司武汉关山大道证券营业部,4,1546.57,2,2961.53,2,"飞荣达,新宏泽,海默科技,"
539,华泰证券股份有限公司南通姚港路证券营业部,5,21424.86,4,4157.43,1,"京汉股份,石化机械,飞荣达"
540,中国国际金融股份有限公司北京建国门外大街证券营业部,3,0.0,0,17769.26,3,"中科创达,陕西金叶,飞荣达"
541,广发证券股份有限公司台州市府大道证券营业部,1,0.0,0,744.0,1,飞荣达
542,西南证券股份有限公司成都天府大道证券营业部,1,0.0,0,496.08,1,飞荣达
543,中信证券（山东）有限责任公司青岛香港中路证券营业部,1,0.0,0,324.11,1,飞荣达
544,中国银河证券股份有限公司北京望京证券营业部,1,425.94,1,0.0,0,新劲刚
545,平安证券股份有限公司重庆分公司,1,0.0,0,283.18,1,飞荣达
546,东方证券股份有限公司杭州龙井路证券营业部,5,704.03,3,5261.8,2,"新劲刚,金陵体育,津膜科技,"
547,安信证券股份有限公司清远金碧路证券营业部,2,390.56,1,369.24,1,新劲刚
548,国元证券股份有限公司北京东直门外大街证券营业部,2,600.26,2,0.0,0,"新劲刚,光莆股份"
549,万联证券有限责任公司广州珠江新城证券营业部,2,0.0,0,1732.33,2,"钧达股份,长川科技"
550,国信证券股份有限公司中山分公司,2,0.0,0,1345.95,2,"汇金通,新劲刚"
551,东海证券股份有限公司杭州秋涛北路证券营业部,1,0.0,0,1050.1,1,长川科技
552,金元证券股份有限公司杭州解放东路证券营业部,2,0.0,0,1154.92,2,"新劲刚,北京君正"
553,东方证券股份有限公司上海闵行区都市路证券营业部,3,1259.55,1,3962.79,2,"太空板业,新劲刚"
554,浙商证券股份有限公司杭州玉古路证券营业部,2,927.51,1,226.21,1,"海虹控股,广和通"
555,浙商证券股份有限公司桐乡世纪大道证券营业部,1,1088.79,1,0.0,0,德艺文创
556,兴业证券股份有限公司厦门杏林湾路证券营业部,3,0.68,3,0.0,0,"万通智控,伟隆股份,金陵体育"
557,华西证券股份有限公司重庆中山三路证券营业部,3,1073.25,2,506.01,1,"大丰实业,德艺文创,力盛赛车"
558,兴业证券股份有限公司福州五四路证券营业部,1,0.28,1,0.0,0,万通智控
559,国信证券股份有限公司昆明安康路证券营业部,1,751.41,1,0.0,0,透景生命
560,长城证券股份有限公司深圳福华三路证券营业部,1,0.0,0,0.31,1,万通智控
561,国泰君安证券股份有限公司上海自贸试验区分公司,2,98.35,1,118.99,1,正元智慧
562,申万宏源证券有限公司长沙蔡锷中路证券营业部,4,1337.32,3,471.71,1,"正元智慧,今飞凯达,德艺文创"
563,恒泰证券股份有限公司呼和浩特锡林南路证券营业部,2,977.27,2,0.0,0,"透景生命,仰帆控股"
564,光大证券股份有限公司南京中山东路证券营业部,1,0.0,0,0.31,1,万通智控
565,华泰证券股份有限公司盐城分公司,1,0.0,0,2.71,1,正元智慧
566,光大证券股份有限公司武汉紫阳路证券营业部,1,0.0,0,0.31,1,万通智控
567,申万宏源证券有限公司沈阳岐山中路证券营业部,1,0.0,0,2.71,1,正元智慧
568,国盛证券有限责任公司南昌物资大楼证券营业部,1,0.0,0,0.31,1,万通智控
569,东方证券股份有限公司上海杨浦区长阳路证券营业部,1,0.0,0,2.52,1,正元智慧
570,海通证券股份有限公司昆明东风西路证券营业部,1,0.0,0,0.31,1,万通智控
571,华泰证券股份有限公司深圳益田路证券营业部,7,3914.14,3,3163.85,4,"天山股份,正元智慧,三超新材,"
572,中信证券股份有限公司上海中信广场证券营业部,1,3.55,1,0.0,0,超频三
573,国联证券股份有限公司南京太平南路证券营业部,1,0.0,0,0.78,1,超频三
574,国信证券股份有限公司佛山季华六路证券营业部,1,0.0,0,0.78,1,超频三
575,信达证券股份有限公司宁波姚隘路证券营业部,2,166.17,1,221.91,1,星云股份
576,万联证券有限责任公司天津西马路证券营业部,1,5.75,1,0.0,0,太龙照明
577,华泰证券股份有限公司北京西三环北路证券营业部,8,5756.47,7,6.19,1,"吴江银行,泰山石油,清源股份,"
578,长江证券股份有限公司麻城将军北路证券营业部,1,0.0,0,1.11,1,太龙照明
579,南京证券股份有限公司宁波锦寓路证券营业部,1,0.12,1,0.0,0,杭州园林
580,方正证券股份有限公司娄底南贸西街证券营业部,1,0.0,0,1.11,1,太龙照明
581,国开证券有限责任公司北京中关村南大街证券营业部,1,0.0,0,0.65,1,杭州园林
582,中国银河证券股份有限公司福州中山路证券营业部,1,0.0,0,4.02,1,星云股份
583,国信证券股份有限公司大连和平广场证券营业部,2,0.0,0,5.35,2,"恒润股份,杭州园林"
584,南京证券股份有限公司银川怀远西路证券营业部,1,0.0,0,1.11,1,太龙照明
585,安信证券股份有限公司肇庆四会光明北路证券营业部,1,0.0,0,2.21,1,星云股份
586,国元证券股份有限公司中山体育路证券营业部,1,0.0,0,0.65,1,杭州园林
587,湘财证券股份有限公司南京江东中路证券营业部,1,0.0,0,1.11,1,太龙照明
588,华林证券股份有限公司江门港口路证券营业部,1,0.0,0,0.65,1,杭州园林
589,华泰证券股份有限公司南京鱼市街证券营业部,1,0.0,0,0.65,1,杭州园林
590,方正证券股份有限公司南京珠江路证券营业部,2,31.96,2,0.0,0,新日股份
591,平安证券股份有限公司辽宁分公司,2,0.0,0,5.09,2,新日股份
592,平安证券股份有限公司陕西分公司,1,0.0,0,2.12,1,新日股份
593,浙商证券股份有限公司厦门分公司,1,0.0,0,1.41,1,新日股份
594,申万宏源西部证券有限公司柳州东环大道证券营业部,1,0.0,0,1.41,1,新日股份
595,长城证券股份有限公司杭州文一西路证券营业部,5,4402.66,2,2873.29,3,"冀东装备,博天环境,石化机械,"
596,申万宏源证券有限公司上海徐汇区斜土路证券营业部,3,10971.28,3,0.0,0,"联泰环保,柳钢股份"
597,东兴证券股份有限公司永安牺和路证券营业部,1,960.49,1,0.0,0,联泰环保
598,国泰君安证券股份有限公司重庆新南路证券营业部,1,398.62,1,0.0,0,大晟文化
599,国泰君安证券股份有限公司福州杨桥东路证券营业部,1,792.91,1,0.0,0,联泰环保
600,东兴证券股份有限公司上海肇嘉浜路证券营业部,3,3372.63,3,0.0,0,"联泰环保,博深工具"
601,安信证券股份有限公司上海黄浦区跨龙路证券营业部,3,753.79,2,169.38,1,"正元智慧,大晟文化,浩云科技"
602,中泰证券股份有限公司厦门松柏路证券营业部,1,874.2,1,0.0,0,柳钢股份
603,光大证券股份有限公司海门江海中路证券营业部,3,2918.62,2,1254.76,1,"坤彩科技,陇神戎发"
604,申万宏源证券有限公司桐乡和平路证券营业部,2,170.72,1,341.81,1,"飞凯材料,大晟文化"
605,光大证券股份有限公司惠州淡水证券营业部,1,774.97,1,0.0,0,柳钢股份
606,湘财证券股份有限公司北京顺义站前街证券营业部,1,0.0,0,291.9,1,大晟文化
607,宏信证券有限责任公司上海桂平路证券营业部,1,0.0,0,2578.47,1,柳钢股份
608,中国银河证券股份有限公司广州大沙东路证券营业部,1,0.0,0,271.42,1,大晟文化
609,招商证券股份有限公司上海肇嘉浜路证券营业部,2,0.0,0,3084.76,2,柳钢股份
610,华泰证券股份有限公司湖南分公司,9,10468.68,5,7436.73,4,"八一钢铁,银龙股份,清源股份,"
611,华鑫证券有限责任公司西安科技路证券营业部,1,0.0,0,239.89,1,大晟文化
612,华融证券股份有限公司上海黄浦区中山东二路证券营业部,2,0.0,0,2697.95,2,柳钢股份
613,联储证券有限责任公司南京江东北路证券营业部,3,1000.34,1,2343.86,2,"柳钢股份,吴江银行"
614,光大证券股份有限公司内江公园街证券营业部,1,689.65,1,0.0,0,大丰实业
615,华泰证券股份有限公司孝感长征路证券营业部,1,581.88,1,0.0,0,大丰实业
616,国泰君安证券股份有限公司绍兴中兴中路证券营业部,1,419.15,1,0.0,0,大丰实业
617,华安证券股份有限公司六安分公司,7,2076.17,3,5162.85,4,"四通新材,龙蟠科技,五洋科技,"
618,中国银河证券股份有限公司长春西民主大街证券营业部,1,0.0,0,850.87,1,大丰实业
619,招商证券股份有限公司佛山南海南平西路证券营业部,1,0.0,0,526.65,1,大丰实业
620,广发证券股份有限公司揭阳临江北路证券营业部,1,0.0,0,519.97,1,大丰实业
621,国信证券股份有限公司义乌城北路证券营业部,3,224.37,1,652.21,2,"光莆股份,北京君正,大丰实业"
622,东方证券股份有限公司深圳金田路证券营业部,2,2877.2,1,2959.28,1,科林电气
623,上海证券有限责任公司瑞安塘下大道证券营业部,1,0.0,0,961.03,1,清源股份
624,中泰证券股份有限公司威海海滨北路证券营业部,2,3750.67,2,0.0,0,科林电气
625,中信证券股份有限公司中山中山四路证券营业部,3,5098.04,2,4583.36,1,"科林电气,中持股份"
626,华泰证券股份有限公司永嘉阳光大道证券营业部,2,1862.41,2,0.0,0,"无锡银行,浩云科技"
627,华福证券有限责任公司莆田城涵东大道证券营业部,1,1857.58,1,0.0,0,科林电气
628,东兴证券股份有限公司福州五四路证券营业部,2,0.0,0,4402.62,2,"*ST中基,清源股份"
629,兴业证券股份有限公司杭州清泰街证券营业部,4,6387.05,4,0.0,0,"韩建河山,横河模具,全信股份,"
630,中国银河证券股份有限公司温州大南路证券营业部,2,0.0,0,6192.18,2,无锡银行
631,东海证券股份有限公司青岛香港中路证券营业部,3,843.59,2,778.14,1,"濮阳惠成,北京君正,清源股份"
632,光大证券股份有限公司深圳金田路证券营业部,6,12372.11,3,10400.15,3,"冀东装备,韩建河山,凤凰光学,"
633,联储证券有限责任公司上海中山西路证券营业部,1,0.0,0,1991.16,1,无锡银行
634,中国银河证券股份有限公司宁波柳汀街证券营业部,3,3712.97,2,898.37,1,"恒泰艾普,大唐发电,科林电气"
635,华安证券股份有限公司温州汤家桥路证券营业部,1,0.0,0,1733.57,1,无锡银行
636,联储证券有限责任公司平顶山中兴路证券营业部,1,0.0,0,1586.07,1,无锡银行
637,华泰证券股份有限公司上海国宾路证券营业部,4,422.82,2,496.1,2,"银之杰,恒润股份,大唐发电"
638,招商证券股份有限公司北京北三环路证券营业部,2,0.0,0,322.87,2,"汇金通,恒润股份"
639,海通证券股份有限公司青岛湛山一路营业部,1,0.0,0,3.88,1,恒润股份
640,世纪证券有限责任公司上海威海路证券营业部,1,0.0,0,3.88,1,恒润股份
641,国联证券股份有限公司江阴大桥北路证券营业部,1,0.0,0,3.88,1,恒润股份
642,方正证券股份有限公司上海西藏南路证券营业部,2,1270.9,1,1351.72,1,格尔软件
643,方正证券股份有限公司天台寒山路证券营业部,2,499.75,1,535.05,1,格尔软件
644,方正证券股份有限公司上海杨高北路证券营业部,2,492.99,1,535.75,1,格尔软件
645,中国中投证券有限责任公司西安友谊东路证券营业部,2,449.31,1,536.61,1,格尔软件
646,海通证券股份有限公司金华八一南街证券营业部,1,36.27,1,0.0,0,格尔软件
647,中信证券（山东）有限责任公司青岛标山路证券营业部,2,782.84,1,18.44,1,"力盛赛车,格尔软件"
648,平安证券股份有限公司芜湖江北证券营业部,3,141.67,1,208.31,2,"凤凰光学,好利来,格尔软件"
649,广发证券股份有限公司佛山岭南大道北证券营业部,1,0.0,0,14.47,1,格尔软件
650,安信证券股份有限公司深圳红荔西路证券营业部,2,2092.09,1,2222.02,1,华建集团
651,信达证券股份有限公司绍兴柯桥山阴路证券营业部,2,3.81,1,746.37,1,"金石资源,川润股份"
652,财通证券股份有限公司丽水松阳要津路证券营业部,1,0.0,0,0.65,1,金石资源
653,浙商证券股份有限公司绍兴金柯桥大道证券营业部,1,970.26,1,0.0,0,华建集团
654,中国中投证券有限责任公司青岛延吉路证券营业部,1,0.0,0,0.65,1,金石资源
655,财通证券股份有限公司重庆邹容路证券营业部,1,0.0,0,2334.35,1,华建集团
656,万联证券有限责任公司广州滨江东路证券营业部,1,0.0,0,0.65,1,金石资源
657,中国银河证券股份有限公司沈阳大北关街证券营业部,1,0.0,0,0.65,1,金石资源
658,中信证券股份有限公司北京建国门证券营业部,1,0.0,0,1067.87,1,华建集团
659,宏信证券有限责任公司上海拱极路证券营业部,2,42.72,2,0.0,0,恒润股份
660,海通证券股份有限公司咸阳沈兴北路证券营业部,1,0.0,0,4.27,1,恒润股份
661,海通证券股份有限公司济南泉城路证券营业部,2,0.0,0,689.65,2,"清源股份,恒润股份"
662,国金证券股份有限公司成都武成大街证券营业部,1,0.0,0,4.27,1,恒润股份
663,中国银河证券股份有限公司南昌广场东路证券营业部,1,0.0,0,4.27,1,恒润股份
664,华福证券有限责任公司福州达道路证券营业部,1,0.0,0,2.14,1,恒润股份
665,国泰君安证券股份有限公司上海打浦路证券营业部,3,1707.96,2,470.5,1,"中葡股份,正虹科技"
666,中国国际金融股份有限公司福州五四路证券营业部,1,1040.5,1,0.0,0,中葡股份
667,太平洋证券股份有限公司厦门分公司,2,716.46,1,706.74,1,中葡股份
668,中国国际金融股份有限公司杭州教工路证券营业部,1,385.24,1,0.0,0,中葡股份
669,申万宏源西部证券有限公司北京金融大街证券营业部,1,0.0,0,679.91,1,中葡股份
670,中国银河证券股份有限公司北京陶然桥证券营业部,1,0.0,0,444.71,1,中葡股份
671,申万宏源西部证券有限公司大连金马路证券营业部,1,0.0,0,441.37,1,中葡股份
672,长江证券股份有限公司太原南内环街证券营业部,1,267.12,1,0.0,0,凤凰光学
673,金元证券股份有限公司海口南宝路证券营业部,1,0.0,0,945.05,1,中油工程
674,安信证券股份有限公司上海杨浦区殷行路证券营业部,1,796.13,1,0.0,0,汇金通
675,申万宏源西部证券有限公司奎屯北京西路证券营业部,1,0.0,0,822.23,1,中油工程
676,安信证券股份有限公司揭阳临江北路证券营业部,2,1975.12,1,669.65,1,"太极实业,中油工程"
677,中国银河证券股份有限公司武汉汉阳大道证券营业部,1,315.5,1,0.0,0,汇金通
678,南京证券股份有限公司江阴人民中路证券营业部,1,0.0,0,972.2,1,凤凰光学
679,长江证券股份有限公司武汉鹦鹉大道证券营业部,1,0.0,0,506.38,1,中油工程
680,申万宏源证券有限公司甘肃分公司,1,283.04,1,0.0,0,汇金通
681,国金证券股份有限公司客户资产管理部,2,0.0,0,916.57,2,"云赛智联,凤凰光学"
682,新时代证券股份有限公司郑州丰产路证券营业部,1,0.0,0,283.63,1,中油工程
683,长城证券股份有限公司深圳宝安海秀路证券营业部,1,198.88,1,0.0,0,汇金通
684,中国银河证券股份有限公司上海肇嘉浜路证券营业部,1,0.0,0,401.66,1,凤凰光学
685,光大证券股份有限公司上海黄浦区西藏中路证券营业部,1,0.0,0,350.7,1,汇金通
686,东北证券股份有限公司常州花园街证券营业部,1,0.0,0,379.94,1,凤凰光学
687,长江证券股份有限公司北京新源里证券营业部,1,0.0,0,270.53,1,汇金通
688,西藏东方财富证券股份有限公司拉萨察古大道第二证券营业部,4,424.63,1,565.4,3,"传艺科技,星云股份,汇金通"
689,华宝证券有限责任公司上海东大名路证券营业部,3,2896.79,3,0.0,0,"内蒙一机,华灿光电,尔康制药"
690,华泰证券股份有限公司北京苏州街证券营业部,1,872.39,1,0.0,0,内蒙一机
691,招商证券股份有限公司深圳福华三路证券营业部,2,689.44,1,3397.61,1,"内蒙一机,京汉股份"
692,中信建投证券股份有限公司衡阳解放西路证券营业部,1,644.29,1,0.0,0,内蒙一机
693,东吴证券股份有限公司苏州狮山路证券营业部,1,0.0,0,1063.71,1,内蒙一机
694,东吴证券股份有限公司杭州文晖路证券营业部,1,0.0,0,911.47,1,内蒙一机
695,海通证券股份有限公司广州珠江西路证券营业部,2,18829.55,2,0.0,0,"龙溪股份,连云港"
696,国泰君安证券股份有限公司顺德东乐路证券营业部,4,8143.16,3,2583.7,1,"龙溪股份,柳钢股份,科林电气"
697,方正证券股份有限公司北京安定门外大街证券营业部,1,2099.42,1,0.0,0,龙溪股份
698,万联证券有限责任公司上海富贵东路证券营业部,1,0.0,0,3982.27,1,龙溪股份
699,中信建投证券股份有限公司襄阳檀溪路证券营业部,1,0.0,0,3717.19,1,龙溪股份
700,西南证券股份有限公司上海田林东路证券营业部,1,0.0,0,3672.75,1,龙溪股份
701,恒泰证券股份有限公司上海成山路证券营业部,1,0.0,0,3039.59,1,龙溪股份
702,国泰君安证券股份有限公司镇江长江路证券营业部,1,0.0,0,2622.68,1,龙溪股份
703,华鑫证券有限责任公司泉州宝洲路证券营业部,2,7902.92,2,0.0,0,无锡银行
704,国海证券股份有限公司上海奉贤路营业部,1,2512.85,1,0.0,0,无锡银行
705,上海证券有限责任公司深圳民田路证券营业部,3,5982.73,2,2338.82,1,"冀东装备,科林电气"
706,东海证券股份有限公司泉州丰泽街证券营业部,5,1620.82,1,13968.39,4,"正虹科技,海虹控股,八一钢铁"
707,方正证券股份有限公司深圳别墅路证券营业部,2,2505.54,1,2074.93,1,科林电气
708,民生证券股份有限公司郑州西太康路证券营业部,2,0.0,0,7763.71,2,无锡银行
709,兴业证券股份有限公司武汉青年路证券营业部,1,0.0,0,1368.47,1,无锡银行
710,长江证券股份有限公司荆州北京西路证券营业部,1,0.0,0,1545.57,1,科林电气
711,华福证券有限责任公司永安新府路证券营业部,2,1227.95,1,237.29,1,"格尔软件,三德科技"
712,财富证券有限责任公司杭州庆春路证券营业部,6,2228.27,4,986.37,2,"星云股份,三超新材,格尔软件,"
713,光大证券股份有限公司苏州苏惠路证券营业部,1,663.39,1,0.0,0,格尔软件
714,光大证券股份有限公司宁波悦盛路证券营业部,3,622.49,2,788.25,1,"格尔软件,迪贝电气,长川科技"
715,广发证券股份有限公司佛山汾江中路证券营业部,3,1237.58,1,4349.81,2,"坤彩科技,冀东水泥,友讯达"
716,光大证券股份有限公司上海浦东新区金科路证券营业部,1,17.79,1,0.0,0,迪贝电气
717,招商证券股份有限公司深圳东门南路证券营业部,2,1180.52,2,0.0,0,"坤彩科技,中科创达"
718,申万宏源西部证券有限公司盐城解放南路证券营业部,1,0.0,0,1.22,1,韦尔股份
719,中信证券股份有限公司余姚南雷路证券营业部,2,679.49,1,2.09,1,"新宏泽,迪贝电气"
720,申万宏源证券有限公司上海浦东新区云台路证券营业部,1,0.0,0,1.22,1,韦尔股份
721,国信证券股份有限公司天津市河西区湘江道47号五矿大厦第一层东大厅及第二层,2,0.0,0,3.05,2,"金石资源,迪贝电气"
722,华泰证券股份有限公司西安文艺北路证券营业部,1,0.0,0,1.22,1,韦尔股份
723,招商证券股份有限公司武汉航空路证券营业部,1,0.0,0,2.09,1,迪贝电气
724,申万宏源证券有限公司重庆杨家坪正街证券营业部,1,0.0,0,2.33,1,新日股份
725,华泰证券股份有限公司南京浦泗路证券营业部,1,0.0,0,1.22,1,韦尔股份
726,国信证券股份有限公司哈尔滨田地街证券营业部,1,0.0,0,2.09,1,迪贝电气
727,长江证券股份有限公司荆门白庙路证券营业部,2,0.0,0,2.89,2,"寿仙谷,韦尔股份"
728,兴业证券股份有限公司深圳海秀路证券营业部,2,2216.96,1,2202.63,1,京汉股份
729,华泰证券股份有限公司重庆春晖路证券营业部,1,1835.78,1,0.0,0,京汉股份
730,海通证券股份有限公司武汉十升路证券营业部,2,1453.26,1,2193.42,1,京汉股份
731,兴业证券股份有限公司深圳分公司,2,4961.43,1,5253.8,1,冀东水泥
732,国泰君安证券股份有限公司北京金桐西路证券营业部,5,6866.58,3,5270.9,2,"冀东装备,渤海股份,张家港行"
733,申万宏源西部证券有限公司深圳福华一路证券营业部,2,1224.53,1,815.72,1,"京汉股份,焦作万方"
734,华泰证券股份有限公司常熟金沙江路证券营业部,2,6699.29,2,0.0,0,冀东水泥
735,中国银河证券股份有限公司深圳景田证券营业部,2,3808.32,2,0.0,0,渤海股份
736,中国中投证券有限责任公司深圳分公司,2,981.96,2,0.0,0,"莱茵体育,高伟达"
737,海通证券股份有限公司北京知春路证券营业部,2,1553.59,1,1397.1,1,渤海股份
738,东北证券股份有限公司广东分公司,1,502.93,1,0.0,0,莱茵体育
739,海通证券股份有限公司南通人民中路证券营业部,1,2075.29,1,0.0,0,冀东水泥
740,中国银河证券股份有限公司杭州绍兴路证券营业部,2,1204.7,1,2202.77,1,渤海股份
741,华鑫证券有限责任公司北京菜市口大街证券营业部,1,0.0,0,2331.78,1,京汉股份
742,方正证券股份有限公司衡阳祁东民生街证券营业部,1,1868.11,1,0.0,0,冀东水泥
743,申万宏源证券有限公司福州鼓屏路证券营业部,2,35.55,1,376.54,1,"国际医学,莱茵体育"
744,兴业证券股份有限公司哈尔滨友谊路证券营业部,1,0.0,0,2219.09,1,京汉股份
745,招商证券股份有限公司温州新城大道证券营业部,2,634.45,1,164.03,1,"深圳华强,莱茵体育"
746,海通证券股份有限公司上海黄浦区福州路证券营业部,2,0.0,0,162.55,2,"莱茵体育,奥翔药业"
747,华泰证券股份有限公司扬中扬子中路证券营业部,1,0.0,0,1701.08,1,冀东水泥
748,方正证券股份有限公司台州解放路证券营业部,1,0.0,0,1547.27,1,冀东水泥
749,长城国瑞证券有限公司福州五一北路证券营业部,1,0.0,0,1544.54,1,冀东水泥
750,华泰证券股份有限公司南京户部街证券营业部,3,2485.57,2,401.05,1,"石化机械,天保基建"
751,华泰证券股份有限公司无锡解放北路证券营业部,1,1712.24,1,0.0,0,石化机械
752,中国中投证券有限责任公司济宁环城西路证券营业部,2,1525.72,1,217.29,1,"石化机械,好利来"
753,东方证券股份有限公司上海浦东新区银城中路证券营业部,2,227.79,1,6363.2,1,"海默科技,石化机械"
754,海通证券股份有限公司哈尔滨通江街证券营业部,2,417.9,1,3856.67,1,石化机械
755,华泰证券股份有限公司北京雍和宫证券营业部,5,28355.44,2,2051.11,3,"津膜科技,*ST鲁丰,石化机械,"
756,国泰君安证券股份有限公司上海静安区南京西路证券营业部,2,1491.03,1,692.18,1,"河北宣工,博深工具"
757,国泰君安证券股份有限公司广西分公司,1,1409.08,1,0.0,0,河北宣工
758,广发证券股份有限公司杭州天目山路证券营业部,2,2881.42,1,826.03,1,"天山股份,连云港"
759,国信证券股份有限公司无锡梁溪路证券营业部,2,1061.72,1,465.9,1,河北宣工
760,海通证券股份有限公司北京密云鼓楼东大街证券营业部,1,0.0,0,1903.96,1,天山股份
761,海通证券股份有限公司嵊州西前街证券营业部,5,6747.05,3,2285.44,2,"千方科技,力盛赛车,天山股份"
762,安信证券股份有限公司佛山北滘证券营业部,3,735.9,2,1.19,1,"中钢国际,中泰桥梁,金陵体育"
763,海通证券股份有限公司上海虹口区新建路证券营业部,1,411.46,1,0.0,0,中钢国际
764,中信证券股份有限公司泉州宝洲路证券营业部,1,391.53,1,0.0,0,中钢国际
765,中泰证券股份有限公司上海赤峰路证券营业部,2,1381.43,1,1792.59,1,"生意宝,柳钢股份"
766,中信建投证券股份有限公司北京青年路证券营业部,2,0.0,0,1234.18,2,"第一创业,生意宝"
767,华西证券股份有限公司深圳民田路证券营业部,3,117.29,1,321.34,2,"陕西金叶,生意宝,奥翔药业"
768,国盛证券有限责任公司上饶市上饶县旭日大道证券营业部,1,0.0,0,286.51,1,生意宝
769,信达证券股份有限公司湛江海滨大道南证券营业部,1,0.0,0,271.33,1,生意宝
770,长江证券股份有限公司成都人民南路证券营业部,4,1705.55,2,7719.69,2,"巨力索具,恒通科技,航发动力"
771,中信证券股份有限公司北京呼家楼证券营业部,3,10175.37,2,2179.29,1,"北新路桥,西部建设"
772,国泰君安证券股份有限公司上海虹桥路证券营业部,1,740.92,1,0.0,0,西部建设
773,深股通专用,5,3707.93,3,5070.85,2,"兔宝宝,尔康制药,西部建设,"
774,中国中投证券有限责任公司东莞虎门证券营业部,1,0.0,0,1449.73,1,巨力索具
775,中国中投证券有限责任公司深圳宝安兴华路证券营业部,2,0.0,0,2162.4,2,"西部建设,青龙管业"
776,华西证券股份有限公司成都高升桥路证券营业部,1,0.0,0,700.55,1,西部建设
777,华鑫证券有限责任公司宁波沧海路证券营业部,4,9117.21,3,768.72,1,"津膜科技,北京科锐,新宏泽"
778,华鑫证券有限责任公司西安西大街证券营业部,3,3703.5,2,2031.22,1,北京科锐
779,华鑫证券有限责任公司赣州翠微路证券营业部,1,1840.78,1,0.0,0,北京科锐
780,华宝证券有限责任公司上海西藏中路证券营业部,1,1822.56,1,0.0,0,北京科锐
781,光大证券股份有限公司北京丽泽路证券营业部,1,0.0,0,608.4,1,北京科锐
782,中银国际证券有限责任公司哈尔滨安定街证券营业部,1,0.0,0,165.82,1,北京科锐
783,安信证券股份有限公司昆明东风西路证券营业部,1,0.0,0,126.41,1,北京科锐
784,东兴证券股份有限公司莆田梅园东路证券营业部,2,2951.53,2,0.0,0,"千方科技,嘉寓股份"
785,中信证券股份有限公司福州连江北路证券营业部,1,0.0,0,1642.12,1,千方科技
786,中信建投证券股份有限公司青岛南京路证券营业部,3,0.0,0,8791.51,3,"海虹控股,千方科技"
787,国泰君安证券股份有限公司北京德外大街证券营业部,1,0.0,0,1545.38,1,千方科技
788,南京证券股份有限公司南京热河路证券营业部,1,1305.98,1,0.0,0,青龙管业
789,东兴证券股份有限公司福州五一北路证券营业部,5,1403.05,2,1446.45,3,"传艺科技,青龙管业,博天环境"
790,中泰证券股份有限公司泰安岱宗大街证券营业部,1,0.0,0,1144.2,1,青龙管业
791,申万宏源证券有限公司绍兴胜利东路证券营业部,1,964.04,1,0.0,0,华斯股份
792,华泰证券股份有限公司深圳侨香路证券营业部,1,916.83,1,0.0,0,华斯股份
793,中信建投证券股份有限公司广州番禺国泰路证券营业部,1,881.39,1,0.0,0,华斯股份
794,中国银河证券股份有限公司温州锦绣路证券营业部,3,628.16,1,1475.03,2,"新宏泽,东凌国际"
795,中天证券股份有限公司上海志丹路证券营业部,1,0.0,0,1140.57,1,新宏泽
796,中信证券股份有限公司湖州环城西路证券营业部,2,977.29,1,894.72,1,力盛赛车
797,华龙证券股份有限公司平凉崆峒东路证券营业部,1,905.18,1,0.0,0,力盛赛车
798,华安证券股份有限公司繁昌迎春东路证券营业部,1,1034.47,1,0.0,0,张家港行
799,长城国瑞证券有限公司厦门南山路证券营业部,1,578.27,1,0.0,0,张家港行
800,国信证券股份有限公司贵阳中华北路证券营业部,1,0.0,0,517.94,1,张家港行
801,东海证券股份有限公司长沙岳麓大道证券营业部,5,2062.48,3,1774.12,2,今飞凯达
802,西藏东方财富证券股份有限公司拉萨金珠西路第一证券营业部,2,262.45,1,514.1,1,"张家港行,北京君正"
803,方正证券股份有限公司六盘水青峰路证券营业部,1,0.0,0,465.84,1,今飞凯达
804,长城证券股份有限公司南京童卫路证券营业部,3,1204.34,1,2339.85,2,钧达股份
805,万联证券有限责任公司成都清江东路证券营业部,2,1159.82,1,1042.41,1,传艺科技
806,中原证券股份有限公司平顶山分公司,2,583.46,1,498.08,1,传艺科技
807,东北证券股份有限公司济南经十东路证券营业部,1,0.0,0,1.46,1,绿康生化
808,方正证券股份有限公司长沙韶山南路证券营业部,2,0.0,0,364.28,2,"长川科技,绿康生化"
809,方正证券股份有限公司郑州嵩山南路证券营业部,2,209.47,1,1.46,1,"高伟达,绿康生化"
810,光大证券股份有限公司乌鲁木齐新华北路证券营业部,1,0.0,0,1.46,1,绿康生化
811,五矿证券有限公司济南马鞍山路证券营业部,1,259.56,1,0.0,0,雷曼股份
812,国泰君安证券股份有限公司上海天山路证券营业部,5,12109.04,4,4395.77,1,"博天环境,佳讯飞鸿,英洛华,"
813,方正证券股份有限公司岳阳华容迎宾北路证券营业部,1,205.24,1,0.0,0,雷曼股份
814,光大证券股份有限公司广州番禺环城东路证券营业部,1,100.34,1,0.0,0,雷曼股份
815,东莞证券股份有限公司东莞南城分公司,1,95.14,1,0.0,0,雷曼股份
816,宏信证券有限责任公司上海分公司,5,1179.35,2,1641.53,3,"佳讯飞鸿,易事特,吴江银行,"
817,申万宏源证券有限公司上海徐汇区上中西路证券营业部,1,0.0,0,104.54,1,雷曼股份
818,中泰证券股份有限公司电子商务分公司,1,0.0,0,83.93,1,雷曼股份
819,中信证券股份有限公司北京北三环中路证券营业部,2,774.65,1,256.76,1,"太空板业,佳讯飞鸿"
820,华泰证券股份有限公司哈尔滨宣化街证券营业部,1,0.0,0,250.25,1,佳讯飞鸿
821,招商证券股份有限公司深圳建安路证券营业部,3,0.0,0,680.21,3,"华灿光电,浩云科技,鸣志电器"
822,中信建投证券股份有限公司揭阳黄岐山大道证券营业部,1,0.0,0,415.56,1,华灿光电
823,中泰证券股份有限公司厦门厦禾路证券营业部,2,857.45,2,0.0,0,"易事特,*ST中富"
824,银泰证券有限责任公司温州蝉街证券营业部,1,0.0,0,358.17,1,华灿光电
825,中泰证券股份有限公司烟台长江路证券营业部,1,337.37,1,0.0,0,易事特
826,南京证券股份有限公司宿迁黄河路证券营业部,1,0.0,0,1382.63,1,易事特
827,中泰证券股份有限公司上海陆家嘴浦电路证券营业部,1,0.0,0,1237.38,1,易事特
828,西南证券股份有限公司岳阳通海南路证券营业部,1,0.0,0,870.06,1,易事特
829,中原证券股份有限公司杭州新塘路证券营业部,1,0.0,0,518.93,1,易事特
830,安信证券股份有限公司北京远大路证券营业部,1,2052.56,1,0.0,0,太空板业
831,中信证券股份有限公司北京总部证券营业部,1,284.32,1,0.0,0,飞凯材料
832,华泰证券股份有限公司南通如东人民路证券营业部,1,1756.3,1,0.0,0,太空板业
833,财富证券有限责任公司青岛山东路证券营业部,1,0.0,0,3952.07,1,太空板业
834,中银国际证券有限责任公司南京庐山路证券营业部,1,170.0,1,0.0,0,飞凯材料
835,中信建投证券股份有限公司上海哈密路证券营业部,1,0.0,0,748.22,1,飞凯材料
836,中航证券有限公司烟台迎春大街证券营业部,1,0.0,0,1672.82,1,太空板业
837,华泰证券股份有限公司武汉民族大道证券营业部,1,0.0,0,267.35,1,飞凯材料
838,海通证券股份有限公司上虞市民大道证券营业部,2,422.65,1,406.62,1,五洋科技
839,中信建投证券股份有限公司上海营口路证券营业部,2,748.3,2,0.0,0,"乐心医疗,五洋科技"
840,国金证券股份有限公司成都温江区柳城商业新街证券营业部,1,0.0,0,995.0,1,五洋科技
841,第一创业证券股份有限公司宁波百丈东路证券营业部,3,270.35,1,624.59,2,"高伟达,五洋科技"
842,东方证券股份有限公司上海浦东新区张杨路证券营业部,1,0.0,0,336.3,1,五洋科技
843,山西证券股份有限公司太原坞城路证券营业部,1,789.68,1,0.0,0,四通新材
844,财通证券股份有限公司杭州西大街证券营业部,1,0.0,0,409.56,1,四通新材
845,海通证券股份有限公司宣城敬亭路证券营业部,1,255.26,1,0.0,0,浩云科技
846,中信证券股份有限公司海宁海昌南路证券营业部,1,0.0,0,359.9,1,四通新材
847,东海证券股份有限公司宁波大闸路证券营业部,1,364.08,1,0.0,0,全信股份
848,东方证券股份有限公司上海嘉定区沪宜公路证券营业部,1,16.36,1,0.0,0,友讯达
849,中信建投证券股份有限公司泰州青年路证券营业部,1,199.89,1,0.0,0,浩云科技
850,首创证券有限责任公司石家庄长江大道证券营业部,2,180.03,1,387.72,1,"全信股份,正元智慧"
851,招商证券股份有限公司北京车公庄西路证券营业部,2,1676.16,2,0.0,0,"海虹控股,友讯达"
852,中信建投证券股份有限公司长沙星沙证券营业部,1,190.35,1,0.0,0,浩云科技
853,安信证券股份有限公司北京青塔西路证券营业部,1,0.0,0,1.19,1,友讯达
854,新时代证券股份有限公司包头南门外大街证券营业部,1,0.0,0,199.42,1,浩云科技
855,招商证券股份有限公司无锡新生路证券营业部,2,24.63,1,335.0,1,"友讯达,全信股份"
856,财通证券股份有限公司玉环广陵路证券营业部,1,0.0,0,1.19,1,友讯达
857,山西证券股份有限公司晋中安宁街证券营业部,1,0.0,0,293.11,1,全信股份
858,长城证券股份有限公司上海民生路证券营业部,2,0.0,0,1.98,2,"金石资源,友讯达"
859,华福证券有限责任公司福州鼓屏路证券营业部,1,0.0,0,276.52,1,全信股份
860,长江证券股份有限公司深圳深南路证券营业部,1,0.0,0,1.19,1,友讯达
861,国泰君安证券股份有限公司梅州新中路证券营业部,1,0.0,0,126.38,1,浩云科技
862,国泰君安证券股份有限公司临海巾山中路证券营业部,1,0.0,0,251.87,1,全信股份
863,中信建投证券股份有限公司萍乡建设东路证券营业部,1,0.0,0,116.35,1,浩云科技
864,中信证券股份有限公司杭州狮山路证券营业部,3,491.59,1,2326.28,2,"乐心医疗,吴江银行"
865,申万宏源西部证券有限公司沈阳十一纬路证券营业部,1,470.44,1,0.0,0,乐心医疗
866,中信证券股份有限公司嵊州时代商务广场证券营业部,3,1201.92,3,0.0,0,"第一创业,微光股份,乐心医疗"
867,中银国际证券有限责任公司杭州庆春路证券营业部,1,0.0,0,301.62,1,乐心医疗
868,湘财证券股份有限公司上海共和新路证券营业部,4,972.84,2,996.4,2,"正元智慧,恒润股份"
869,海通证券股份有限公司郑州经七路证券营业部,2,784.74,1,891.62,1,长川科技
870,中信建投证券股份有限公司深圳深南中路证券营业部,2,644.97,1,663.45,1,长川科技
871,华鑫证券有限责任公司昆明北京路证券营业部,3,1028.77,2,469.64,1,"恒润股份,正元智慧"
872,万联证券有限责任公司广州增城荔乡路证券营业部,2,434.91,1,442.06,1,正元智慧
873,广发证券股份有限公司深圳彩田路证券营业部,1,450.61,1,0.0,0,新劲刚
874,光大证券股份有限公司上海淮海中路证券营业部,2,10.1,1,27.67,1,"杭州园林,正元智慧"
875,海通证券股份有限公司营口昆仑大街证券营业部,1,0.0,0,423.95,1,新劲刚
876,海通证券股份有限公司泉州田安路证券营业部,2,595.11,1,290.67,1,"湘潭电化,新劲刚"
877,国泰君安证券股份有限公司深圳分公司,1,10.19,1,0.0,0,金石资源
878,东海证券股份有限公司洛阳凯旋西路证券营业部,2,0.0,0,10.27,2,新日股份
879,广州证券股份有限公司广州增城夏街大道证券营业部,2,0.0,0,8.4,2,新日股份
880,财通证券股份有限公司海宁水月亭西路证券营业部,1,0.0,0,0.79,1,金石资源
881,申万宏源西部证券有限公司上海虹口区中山北一路证券营业部,1,0.0,0,3.42,1,新日股份
882,中信证券股份有限公司上海沪闵路证券营业部,1,0.0,0,3.42,1,新日股份
883,国泰君安证券股份有限公司兰州酒泉路证券营业部,1,0.0,0,0.79,1,金石资源
884,新时代证券股份有限公司北京中关村东路证券营业部,1,109.93,1,0.0,0,云赛智联
885,中泰证券股份有限公司上海新松江路证券营业部,1,59.15,1,0.0,0,云赛智联
886,申万宏源证券有限公司上海闵行区碧江路证券营业部,1,51.55,1,0.0,0,云赛智联
887,海通证券股份有限公司上海普陀区大华一路证券营业部,2,33.72,1,1708.98,1,"恒泰艾普,云赛智联"
888,中泰证券股份有限公司徐州民主南路证券营业部,1,0.0,0,320.85,1,云赛智联
889,华安证券股份有限公司成都高升桥路证券营业部,1,0.0,0,82.73,1,云赛智联
890,中信建投证券股份有限公司成都南一环路证券营业部,2,101.66,1,3397.76,1,"银河生物,航天机电"
891,渤海证券股份有限公司天津卫津南路证券营业部,2,72.15,1,1.78,1,"航天机电,太龙照明"
892,渤海证券股份有限公司天津友谊路证券营业部,1,42.64,1,0.0,0,航天机电
893,中泰证券股份有限公司日照昭阳路证券营业部,1,35.24,1,0.0,0,航天机电
894,中国银河证券股份有限公司湖州证券营业部,2,0.0,0,184.32,2,"绿康生化,航天机电"
895,光大证券股份有限公司宁波甬江大道证券营业部,3,6230.8,2,1995.3,1,"大唐发电,张家港行"
896,申万宏源证券有限公司北京劲松九区证券营业部,1,0.0,0,128.21,1,航天机电
897,华安证券股份有限公司天津围堤道证券营业部,1,2239.11,1,0.0,0,大唐发电
898,东北证券股份有限公司长春建设街证券营业部,1,0.0,0,91.2,1,航天机电
899,西部证券股份有限公司北京德胜门外大街证券营业部,1,0.0,0,653.78,1,大唐发电
900,五矿证券有限公司杭州市心北路证券营业部,1,3032.39,1,0.0,0,西部资源
901,国盛证券有限责任公司杭州萧绍路证券营业部,1,1505.11,1,0.0,0,西部资源
902,中信证券(山东)有限责任公司济宁吴泰闸路证券营业部,1,1378.3,1,0.0,0,西部资源
903,中信证券（山东）有限责任公司青岛东海西路证券营业部,4,96.0,1,5243.45,3,"国际医学,冀东水泥,中持股份,"
904,湘财证券股份有限公司哈尔滨中山路证券营业部,1,0.0,0,2004.67,1,西部资源
905,中国中投证券有限责任公司上海东方路证券营业部,1,0.0,0,1741.49,1,西部资源
906,太平洋证券股份有限公司温州百里西路证券营业部,1,0.0,0,1218.06,1,西部资源
907,申万宏源证券有限公司上海长宁区双流路证券营业部,2,0.0,0,1197.23,2,"韦尔股份,西部资源"
908,国都证券股份有限公司深圳金田路证券营业部,1,0.0,0,487.58,1,清源股份
909,国金证券股份有限公司厦门湖滨北路证券营业部,4,3629.0,3,317.36,1,"正元智慧,科林电气,中化岩土"
910,华西证券股份有限公司南充阆中天马寺街证券营业部,1,1157.42,1,0.0,0,科林电气
911,华福证券有限责任公司龙海工农路证券营业部,2,1036.16,1,1097.97,1,吴江银行
912,东兴证券股份有限公司龙海公园路证券营业部,1,798.61,1,0.0,0,吴江银行
913,长江证券股份有限公司厦门鹭江道证券营业部,1,0.0,0,1276.28,1,吴江银行
914,海通证券股份有限公司杭州环城西路证券营业部,3,5009.98,2,1176.96,1,"海虹控股,吴江银行"
915,宏信证券有限责任公司成都福兴街证券营业部,1,19.01,1,0.0,0,奥翔药业
916,申万宏源西部证券有限公司杭州莫干山路证券营业部,1,0.0,0,1.13,1,奥翔药业
917,平安证券股份有限公司深圳蛇口招商路招商大厦证券营业部,1,0.0,0,1.13,1,奥翔药业
918,招商证券股份有限公司南京中山南路证券营业部,3,1769.39,1,346.67,2,"京汉股份,国际医学,奥翔药业"
919,中国中投证券有限责任公司郑州建设路证券营业部,1,0.0,0,1.13,1,奥翔药业
920,平安证券股份有限公司海口国贸大道证券营业部,1,0.0,0,1.13,1,奥翔药业
921,长江证券股份有限公司上海东明路证券营业部,1,1990.4,1,0.0,0,中持股份
922,兴业证券股份有限公司广西分公司,1,1494.13,1,0.0,0,中持股份
923,爱建证券有限责任公司爱建证券总部,2,30.39,2,0.0,0,"鸣志电器,寿仙谷"
924,方正证券股份有限公司温岭泽楚路证券营业部,1,1.35,1,0.0,0,鸣志电器
925,海通证券股份有限公司广州东风西路证券营业部,1,0.0,0,2172.14,1,中持股份
926,兴业证券股份有限公司广东分公司,1,0.0,0,620.83,1,中持股份
927,第一创业证券股份有限公司上海世纪大道证券营业部,1,0.0,0,1.62,1,鸣志电器
928,中山证券有限责任公司海城海州大街证券营业部,1,0.0,0,1.62,1,鸣志电器
929,中信证券股份有限公司河北分公司,2,0.0,0,1336.67,2,中持股份
930,中国中投证券有限责任公司广州珠江东路证券营业部,1,0.0,0,1.62,1,鸣志电器
931,平安证券股份有限公司广东分公司,1,0.0,0,1.62,1,鸣志电器
932,中信证券股份有限公司浦江恒昌财富广场证券营业部,1,0.0,0,4.7,1,恒润股份
933,爱建证券有限责任公司厦门湖滨一里证券营业部,2,0.0,0,450.58,2,"中航黑豹,恒润股份"
934,川财证券有限责任公司犍为滨江路证券营业部,1,0.0,0,4.7,1,恒润股份
935,海通证券股份有限公司,1,3817.04,1,0.0,0,康恩贝
936,金元证券股份有限公司,1,175.75,1,0.0,0,康恩贝
937,中信证券股份有限公司,1,124.03,1,0.0,0,康恩贝
938,东吴证券股份有限公司,1,52.52,1,0.0,0,康恩贝
939,华泰证券股份有限公司,2,951.87,2,0.0,0,"鹏博士,康恩贝"
940,东海证券股份有限公司上海水城南路证券营业部,2,1302.71,1,2899.48,1,"联泰环保,海虹控股"
941,华泰证券股份有限公司苏州现代大道证券营业部,1,1377.55,1,0.0,0,京汉股份
942,中泰证券股份有限公司北京丹棱街证券营业部,1,735.36,1,0.0,0,京汉股份
943,浙商证券股份有限公司玉环长兴路证券营业部,1,56.88,1,0.0,0,国际医学
944,华泰证券股份有限公司泰兴国庆西路证券营业部,1,0.0,0,1129.06,1,京汉股份
945,安信证券股份有限公司北京建国门外大街证券营业部,1,480.08,1,0.0,0,泰山石油
946,申万宏源西部证券有限公司乌鲁木齐友好路证券营业部,2,0.0,0,2104.57,2,"泰山石油,*ST中基"
947,申万宏源证券有限公司成都火车南站东路证券营业部,3,8065.04,3,0.0,0,海虹控股
948,财达证券股份有限公司唐山龙泽路证券营业部,3,19.98,1,2526.8,2,国际医学
949,中国银河证券股份有限公司南宁园湖南路证券营业部,1,16.85,1,0.0,0,国际医学
950,中信证券股份有限公司晋江长兴路证券营业部,1,0.0,0,997.15,1,泰山石油
951,兴业证券股份有限公司漳州胜利东路证券营业部,1,0.0,0,2373.61,1,海虹控股
952,中国民族证券有限责任公司苏州玉山路证券营业部,1,0.0,0,442.21,1,国际医学
953,安信证券股份有限公司石家庄裕华东路证券营业部,1,0.0,0,982.77,1,泰山石油
954,国信证券股份有限公司漳州水仙大街证券营业部,2,0.0,0,6001.3,2,海虹控股
955,华鑫证券有限责任公司上海松江证券营业部,5,2354.13,3,1762.24,2,"星云股份,绿康生化,友讯达,"
956,五矿证券交易单元(390132),1,0.0,0,918.0,1,泰山石油
957,招商证券股份有限公司厦门湖滨东路证券营业部,1,0.0,0,1960.61,1,海虹控股
958,国信证券股份有限公司达州金龙大道证券营业部,1,0.0,0,120.8,1,国际医学
959,华福证券有限责任公司永春留安路证券营业部,1,0.0,0,1827.65,1,海虹控股
960,英大证券有限责任公司深圳福华三路证券营业部,1,0.0,0,82.62,1,国际医学
961,中信建投证券股份有限公司郑州经三北路证券营业部,1,806.93,1,0.0,0,正虹科技
962,国泰君安证券股份有限公司福州华林路证券营业部,2,120.57,1,107.43,1,正虹科技
963,方正证券股份有限公司深圳福中路证券营业部,2,1149.58,2,0.0,0,陕西金叶
964,国元证券股份有限公司深圳百花二路证券营业部,1,5436.66,1,0.0,0,银河生物
965,东海证券股份有限公司福清中环路证券营业部,1,89.66,1,0.0,0,正虹科技
966,中天证券股份有限公司沈阳十三纬路证券营业部,2,122.5,2,0.0,0,正虹科技
967,中山证券有限责任公司上海成山路证券营业部,1,4155.46,1,0.0,0,银河生物
968,银泰证券有限责任公司郑州东风路证券营业部,4,0.0,0,7867.56,4,"海虹控股,正虹科技"
969,华泰证券股份有限公司上海黄浦区来福士广场证券营业部,2,9.55,1,453.75,1,"金陵体育,英洛华"
970,金元证券股份有限公司南京广州路证券营业部,1,0.0,0,7713.08,1,银河生物
971,方正证券股份有限公司厦门厦禾路证券营业部,2,0.0,0,1827.22,2,正虹科技
972,华宝证券有限责任公司上海浦东新区东方路证券营业部,2,922.6,1,6853.15,1,"茂业商业,银河生物"
973,恒泰证券股份有限公司鄂尔多斯薛家湾准格尔路证券营业部,1,0.0,0,134.85,1,英洛华
974,光大证券股份有限公司茂名站前五路证券营业部,1,0.0,0,213.5,1,陕西金叶
975,广发证券股份有限公司云浮浩林东路证券营业部,1,0.0,0,108.75,1,英洛华
976,渤海证券股份有限公司西安劳动南路证券营业部,1,0.0,0,211.12,1,陕西金叶
977,西部证券股份有限公司江阴滨江东路证券营业部,1,0.0,0,3192.59,1,银河生物
978,中信建投证券股份有限公司泉州丰泽街证券营业部,1,0.0,0,201.38,1,正虹科技
979,平安证券股份有限公司福建分公司,1,0.0,0,107.71,1,英洛华
980,长江证券股份有限公司武汉友谊路证券营业部,1,0.0,0,192.7,1,陕西金叶
981,中山证券有限责任公司泉州丰泽街证券营业部,3,0.0,0,2712.72,3,"国际医学,正虹科技"
982,平安证券股份有限公司深圳分公司,1,0.0,0,168.14,1,陕西金叶
983,国海证券股份有限公司长沙中意一路证券营业部,1,4655.44,1,0.0,0,东凌国际
984,中国银河证券股份有限公司广州广州大道中证券营业部,1,31.84,1,0.0,0,*ST东数
985,浙商证券股份有限公司青田华庭街证券营业部,1,734.0,1,0.0,0,川润股份
986,太平洋证券股份有限公司温州车站大道证券营业部,1,3906.56,1,0.0,0,东凌国际
987,招商证券股份有限公司北京北三环东路证券营业部,2,419.93,1,1694.16,1,"川润股份,信邦制药"
988,中信证券（山东）有限责任公司即墨蓝鳌路证券营业部,1,2556.23,1,0.0,0,东凌国际
989,国信证券股份有限公司太原府西街证券营业部,1,10.16,1,0.0,0,*ST东数
990,光大证券股份有限公司成都武成大街证券营业部,1,324.56,1,0.0,0,川润股份
991,申万宏源证券有限公司上海虹口区黄浦路证券营业部,1,308.87,1,0.0,0,川润股份
992,中信证券股份有限公司杭州文三路证券营业部,1,8.58,1,0.0,0,*ST东数
993,中国银河证券股份有限公司北京亦庄证券营业部,1,0.0,0,1050.31,1,东凌国际
994,华创证券有限责任公司德阳黄河西路证券营业部,1,300.55,1,0.0,0,川润股份
995,国融证券股份有限公司深圳深南大道营业部,1,0.0,0,1042.82,1,东凌国际
996,兴业证券股份有限公司内蒙古分公司,1,0.0,0,60.38,1,*ST东数
997,东吴证券股份有限公司常熟商城中路证券营业部,1,0.0,0,1693.63,1,川润股份
998,平安证券股份有限公司南通外环北路证券营业部,1,0.0,0,1022.92,1,东凌国际
999,光大证券股份有限公司宁波解放南路证券营业部,2,31.47,1,53.76,1,"太龙照明,*ST东数"
1000,国海证券股份有限公司金华宾虹路证券营业部,1,0.0,0,1124.12,1,川润股份
1001,五矿证券有限公司北京广安门外大街证券营业部,1,0.0,0,983.27,1,东凌国际
1002,金元证券股份有限公司北京广渠门内大街证券营业部,2,0.0,0,33.9,2,"伟隆股份,*ST东数"
1003,华融证券股份有限公司上海浦东新区杨高南路证券营业部,1,0.0,0,20.08,1,*ST东数
1004,华安证券股份有限公司重庆分公司,1,0.0,0,649.69,1,川润股份
1005,东北证券股份有限公司白山通江路证券营业部,1,0.0,0,2222.42,1,冀东装备
1006,长江证券股份有限公司广州天河北路证券营业部,1,0.0,0,2051.95,1,冀东装备
1007,联讯证券股份有限公司沈阳大西路证券营业部,3,7015.12,2,606.75,1,"北新路桥,渤海股份,连云港"
1008,大同证券有限责任公司晋中迎宾西街证券营业部,2,3988.45,1,2898.02,1,北新路桥
1009,东北证券股份有限公司北京朝外大街证券营业部,1,3463.89,1,0.0,0,*ST鲁丰
1010,光大证券股份有限公司北京东中街证券营业部,1,0.0,0,2009.74,1,北新路桥
1011,中信证券（山东）有限责任公司邹平黛溪三路证券营业部,2,1540.46,1,3084.58,1,*ST鲁丰
1012,国联证券股份有限公司杭州中山北路证券营业部,5,4781.4,4,1218.59,1,"钧达股份,北京科锐"
1013,中信证券（山东）有限责任公司济南分公司,1,0.0,0,2448.46,1,*ST鲁丰
1014,首创证券有限责任公司北京北辰东路证券营业部,4,0.0,0,18192.75,4,"航天机电,北京科锐"
1015,华西证券股份有限公司成都西玉龙街证券营业部,2,2088.7,2,0.0,0,"长川科技,共达电声"
1016,光大证券股份有限公司金华宾虹路证券营业部,3,2546.2,3,0.0,0,"连云港,永和智控,南方轴承"
1017,中信证券股份有限公司常州环府路证券营业部,2,307.67,1,349.21,1,南方轴承
1018,长城证券股份有限公司重庆观音桥步行街证券营业部,1,352.44,1,0.0,0,共达电声
1019,光大证券股份有限公司上海蒙山路证券营业部,1,246.67,1,0.0,0,南方轴承
1020,长江证券股份有限公司江门东华二路证券营业部,1,334.65,1,0.0,0,共达电声
1021,华泰证券股份有限公司武汉首义路证券营业部,1,319.71,1,0.0,0,共达电声
1022,国信证券股份有限公司四川第一分公司,1,0.0,0,4100.49,1,共达电声
1023,中信证券（山东）有限责任公司青岛香港东路证券营业部,1,0.0,0,808.64,1,南方轴承
1024,华创证券有限责任公司南京珠江路证券营业部,1,0.0,0,394.57,1,南方轴承
1025,红塔证券股份有限公司长沙八一路证券营业部,1,0.0,0,1747.38,1,共达电声
1026,华鑫证券有限责任公司常州晋陵中路证券营业部,2,817.24,1,390.11,1,"连云港,南方轴承"
1027,国海证券股份有限公司成都天仁路证券营业部,1,0.0,0,1003.99,1,共达电声
1028,长江证券股份有限公司沈阳三好街证券营业部,1,0.0,0,327.61,1,南方轴承
1029,华创证券有限责任公司开阳开州大道证券营业部,1,1167.8,1,0.0,0,第一创业
1030,长江证券股份有限公司兴化花园路证券营业部,1,532.26,1,0.0,0,第一创业
1031,广发证券股份有限公司深圳天安创新科技广场证券营业部,1,0.0,0,523.42,1,第一创业
1032,东方证券股份有限公司长春同志街证券营业部,1,0.0,0,468.8,1,第一创业
1033,国海证券股份有限公司南宁东葛路证券营业部,1,0.0,0,465.66,1,第一创业
1034,华安证券股份有限公司合肥润安大厦证券营业部,2,446.41,1,443.43,1,今飞凯达
1035,东吴证券股份有限公司南京中山南路证券营业部,1,325.12,1,0.0,0,今飞凯达
1036,华泰证券股份有限公司沈阳光荣街证券营业部,2,842.65,1,926.86,1,钧达股份
1037,华泰证券股份有限公司苏州人民路证券营业部,3,324.4,1,1166.52,2,"中航地产,今飞凯达,龙蟠科技"
1038,广发证券股份有限公司烟台环山路证券营业部,1,0.0,0,1.92,1,绿康生化
1039,恒泰证券股份有限公司北京东直门内北小街证券营业部,1,0.0,0,1.92,1,绿康生化
1040,长江证券股份有限公司青岛延安三路证券营业部,1,0.0,0,1.6,1,绿康生化
1041,长江证券股份有限公司枣阳大南街证券营业部,1,0.0,0,1.6,1,绿康生化
1042,华泰证券股份有限公司深圳侨香路智慧广场证券营业部,2,549.23,1,719.59,1,传艺科技
1043,中泰证券股份有限公司济南历山路证券营业部,1,490.97,1,0.0,0,传艺科技
1044,光大证券股份有限公司宁海气象北路证券营业部,1,453.36,1,0.0,0,北京君正
1045,华泰证券股份有限公司宁波柳汀街证券营业部,1,274.14,1,0.0,0,北京君正
1046,上海证券有限责任公司杭州文二路证券营业部,2,3913.83,2,0.0,0,"恒泰艾普,中化岩土"
1047,东兴证券股份有限公司宁德蕉城北路证券营业部,1,2434.89,1,0.0,0,恒泰艾普
1048,五矿证券有限公司成都天府新区南湖商业街证券营业部,1,0.0,0,243.82,1,北京君正
1049,东兴证券股份有限公司泉州温陵北路证券营业部,2,0.0,0,2548.66,2,"恒泰艾普,升达林业"
1050,国联证券股份有限公司北京石景山路证券营业部,1,0.0,0,1799.24,1,恒泰艾普
1051,江海证券有限公司深圳解放路证券营业部,1,0.0,0,171.77,1,北京君正
1052,申万宏源证券有限公司青岛分公司,1,0.0,0,156.82,1,北京君正
1053,中信证券（山东）有限责任公司烟威分公司,1,326.42,1,0.0,0,隆华节能
1054,中信证券股份有限公司安徽分公司,1,234.83,1,0.0,0,隆华节能
1055,西南证券股份有限公司西安高新路证券营业部,1,0.0,0,690.23,1,隆华节能
1056,广发证券股份有限公司普宁流沙证券营业部,2,0.0,0,755.1,2,"银之杰,隆华节能"
1057,国泰君安证券股份有限公司洛阳中州中路证券营业部,1,0.0,0,297.2,1,隆华节能
1058,东北证券股份有限公司武汉香港路证券营业部,1,3998.42,1,0.0,0,尔康制药
1059,广发证券股份有限公司珠海情侣中路证券营业部,2,1612.86,1,0.95,1,"尔康制药,杭州园林"
1060,中泰证券股份有限公司招远温泉路证券营业部,1,1132.64,1,0.0,0,尔康制药
1061,华西证券股份有限公司北京紫竹院路证券营业部,1,0.0,0,6859.92,1,尔康制药
1062,财富证券有限责任公司长沙韶山北路证券营业部,2,0.0,0,1604.32,2,"湘潭电化,尔康制药"
1063,中信建投证券股份有限公司北京亦庄荣华中路证券营业部,1,0.0,0,881.42,1,华灿光电
1064,财通证券股份有限公司绍兴县柯桥湖西路证券营业部,1,0.0,0,248.53,1,濮阳惠成
1065,东吴证券股份有限公司上海奉贤环城东路证券营业部,1,0.0,0,663.85,1,华灿光电
1066,中国银河证券股份有限公司上海长宁区镇宁路证券营业部,3,1299.93,1,1543.83,2,"太极实业,濮阳惠成"
1067,国泰君安证券股份有限公司杭州庆春路证券营业部,1,0.0,0,161.39,1,濮阳惠成
1068,信达证券股份有限公司北京西单北大街证券营业部,1,398.11,1,0.0,0,强力新材
1069,财通证券股份有限公司杭州江滨西大道证券营业部,1,0.0,0,290.8,1,强力新材
1070,万联证券有限责任公司耒阳五一东路证券营业部,1,0.0,0,238.48,1,强力新材
1071,东北证券股份有限公司上海虹口区吴淞路证券营业部,1,828.73,1,0.0,0,陇神戎发
1072,华泰证券股份有限公司深圳益田路荣超商务中心第二证券营业部,2,604.95,1,620.9,1,三超新材
1073,华泰证券股份有限公司北京广渠门内大街证券营业部,2,869.89,1,1253.18,1,"长川科技,美盛文化"
1074,东方证券股份有限公司北海北海大道证券营业部,1,414.17,1,0.0,0,长川科技
1075,光大证券股份有限公司杭州庆春路证券营业部,2,3307.25,2,0.0,0,"光莆股份,万通智控"
1076,国融证券股份有限公司长沙芙蓉中路证券营业部,1,2.55,1,0.0,0,万通智控
1077,大通证券股份有限公司南宁金湖路证券营业部,1,0.0,0,0.37,1,万通智控
1078,大同证券有限责任公司临汾平阳南街证券营业部,1,0.0,0,0.37,1,万通智控
1079,方正证券股份有限公司湘潭韶山中路证券营业部,2,184.28,1,0.37,1,"湘潭电化,万通智控"
1080,中信证券（山东）有限责任公司平度人民路证券营业部,1,0.0,0,0.37,1,万通智控
1081,中信证券股份有限公司宁波甬江大道证券营业部,1,6.01,1,0.0,0,超频三
1082,万联证券有限责任公司沈阳恒达路证券营业部,1,4.34,1,0.0,0,超频三
1083,海通证券股份有限公司遵义中华南路证券营业部,1,0.0,0,1.8,1,超频三
1084,中国银河证券股份有限公司厦门嘉禾路证券营业部,1,0.0,0,1.32,1,超频三
1085,广发证券股份有限公司咸阳世纪大道证券营业部,1,0.0,0,0.94,1,超频三
1086,国都证券股份有限公司周口光荣路证券营业部,1,0.0,0,0.94,1,超频三
1087,国金证券股份有限公司邛崃东星大道证券营业部,1,0.0,0,0.94,1,超频三
1088,华鑫证券有限责任公司上海茅台路证券营业部,3,1294.35,2,818.27,1,"星云股份,恒润股份"
1089,财通证券股份有限公司无锡政和大道证券营业部,4,777.11,2,352.38,2,"友讯达,星云股份,超频三"
1090,招商证券股份有限公司北京知春东里证券营业部,3,763.86,1,522.24,2,"风神股份,连云港,星云股份"
1091,新时代证券股份有限公司郑州经八路证券营业部,1,0.86,1,0.0,0,杭州园林
1092,国泰君安证券股份有限公司九江甘棠路证券营业部,1,0.0,0,0.79,1,杭州园林
1093,华安证券股份有限公司广州东华南路证券营业部,1,0.0,0,0.79,1,杭州园林
1094,西南证券股份有限公司北京北三环中路证券营业部,1,0.0,0,0.72,1,杭州园林
1095,东方证券股份有限公司上海静安区乌鲁木齐北路证券营业部,1,0.0,0,0.16,1,杭州园林
1096,东吴证券股份有限公司张家港杨舍证券营业部,1,0.0,0,1.47,1,太龙照明
1097,东莞证券股份有限公司东莞鸿福路第一国际证券营业部,1,0.0,0,1.47,1,太龙照明
1098,国盛证券有限责任公司南昌朝阳中路证券营业部,1,0.0,0,1.47,1,太龙照明
1099,方正证券股份有限公司益阳长益路证券营业部,1,0.0,0,0.99,1,金陵体育
1100,国泰君安证券股份有限公司南京中央路证券营业部,1,0.0,0,0.99,1,金陵体育
1101,华创证券有限责任公司贵阳北京路证券营业部,1,0.0,0,0.99,1,金陵体育
1102,中信证券股份有限公司北京金融大街证券营业部,3,6322.1,3,0.0,0,"海虹控股,航天机电,第一创业"
1103,东吴证券股份有限公司苏州望亭镇牡丹路证券营业部,1,671.93,1,0.0,0,中航地产
1104,东吴证券股份有限公司上海西藏南路证券营业部,1,146.94,1,0.0,0,国际医学
1105,中国中投证券有限责任公司南充白土坝路证券营业部,1,128.0,1,0.0,0,国际医学
1106,安信证券股份有限公司绵阳涪城路证券营业部,2,349.03,1,0.45,1,"中航地产,万通智控"
1107,中信建投证券股份有限公司广州体育东路证券营业部,1,952.66,1,0.0,0,深圳华强
1108,国信证券股份有限公司佛山南海大道证券营业部,1,96.0,1,0.0,0,国际医学
1109,申万宏源证券有限公司无锡清扬路证券营业部,1,298.93,1,0.0,0,中航地产
1110,湘财证券股份有限公司北京首体南路证券营业部,1,79.94,1,0.0,0,国际医学
1111,国泰君安证券股份有限公司上海团结路证券营业部,1,0.0,0,1345.41,1,中航地产
1112,国泰君安证券股份有限公司温州江滨西路证券营业部,1,0.0,0,832.0,1,国际医学
1113,国泰君安证券股份有限公司襄阳襄城西街证券营业部,1,0.0,0,1140.42,1,深圳华强
1114,申万宏源证券有限公司厦门分公司,1,0.0,0,1317.73,1,中航地产
1115,海通证券股份有限公司马鞍山湖东中路证券营业部,1,0.0,0,1243.06,1,中航地产
1116,海通证券股份有限公司深圳分公司红岭南路证券营业部,2,2431.11,1,553.92,1,"柳钢股份,深圳华强"
1117,中银国际证券有限责任公司泉州丰泽街证券营业部,1,0.0,0,344.77,1,国际医学
1118,中信建投证券股份有限公司北京三里河路证券营业部,2,0.0,0,1459.67,2,"陇神戎发,中航地产"
1119,华西证券股份有限公司成都东一环路证券营业部,1,0.0,0,495.59,1,深圳华强
1120,申万宏源证券有限公司上海闵行区莘松路证券营业部,1,0.0,0,753.0,1,中航地产
1121,国信证券股份有限公司深圳深南中路证券营业部,1,0.0,0,2696.32,1,海虹控股
1122,天风证券股份有限公司岳阳金鹗中路证券营业部,1,81.67,1,0.0,0,正虹科技
1123,中山证券有限责任公司武汉新华路证券营业部,1,53.4,1,0.0,0,正虹科技
1124,中国中投证券有限责任公司天津蓟县迎宾路证券营业部,1,42.03,1,0.0,0,正虹科技
1125,申万宏源证券有限公司镇江中山东路证券营业部,3,2535.09,2,2200.01,1,"渤海股份,易华录"
1126,兴业证券股份有限公司石狮八七路证券营业部,2,0.0,0,2214.19,2,正虹科技
1127,中国中投证券有限责任公司深圳人民北路证券营业部,3,1551.06,2,20.34,1,"京汉股份,红太阳,正虹科技"
1128,华安证券股份有限公司上海浦东南路证券营业部,3,3354.75,2,3539.48,1,"风神股份,冀东装备"
1129,招商证券股份有限公司珠海人民西路证券营业部,2,1226.39,2,0.0,0,"*ST中基,新宏泽"
1130,国都证券股份有限公司长春人民大街证券营业部,1,493.97,1,0.0,0,*ST中基
1131,国元证券股份有限公司蚌埠兴业街证券营业部,1,338.65,1,0.0,0,*ST中基
1132,中航证券有限公司南昌广场南路证券营业部,1,263.46,1,0.0,0,*ST中基
1133,财通证券股份有限公司上海漕溪路证券营业部,1,454.89,1,0.0,0,天保基建
1134,中信建投证券股份有限公司福州东街证券营业部,2,1047.97,1,852.17,1,湘潭电化
1135,中信建投证券股份有限公司成都天府三街证券营业部,2,757.56,1,637.94,1,湘潭电化
1136,南京证券股份有限公司南京云南北路证券营业部,1,314.65,1,0.0,0,天保基建
1137,东吴证券股份有限公司苏州石路证券营业部,2,0.0,0,972.21,2,"升达林业,*ST中基"
1138,长城证券股份有限公司杭州钱江路证券营业部,2,0.0,0,296.04,2,"*ST中基,金石资源"
1139,中泰证券股份有限公司奉化南山路证券营业部,1,0.0,0,681.6,1,天保基建
1140,国泰君安证券股份有限公司成都双庆路证券营业部,1,0.0,0,3150.63,1,湘潭电化
1141,东吴证券股份有限公司苏州西北街证券营业部,2,3838.66,2,0.0,0,"嘉寓股份,汉钟精机"
1142,华泰证券股份有限公司南京中华路证券营业部,1,0.0,0,6313.91,1,汉钟精机
1143,东莞证券股份有限公司北京分公司,1,0.0,0,581.59,1,湘潭电化
1144,财通证券股份有限公司新昌环城南路证券营业部,1,93.21,1,0.0,0,美盛文化
1145,国信证券股份有限公司西安友谊东路证券营业部,3,3704.75,3,0.0,0,"国际医学,美盛文化"
1146,光大证券股份有限公司东莞元美路证券营业部,1,0.0,0,1853.08,1,中化岩土
1147,申万宏源证券有限公司南京浦口凤凰大街证券营业部,1,0.0,0,1177.44,1,中化岩土
1148,招商证券股份有限公司北京建国路证券营业部,2,0.0,0,1142.84,2,"中化岩土,先达股份"
1149,国联证券股份有限公司成都锦城大道证券营业部,2,1143.56,2,0.0,0,"可立克,三德科技"
1150,财富证券有限责任公司益阳康富南路证券营业部,1,409.91,1,0.0,0,可立克
1151,长江证券股份有限公司焦作民主南路证券营业部,1,0.0,0,217.81,1,可立克
1152,中国民族证券有限责任公司鞍山人民路证券营业部,1,0.0,0,146.53,1,可立克
1153,中国银河证券股份有限公司杭州新塘路证券营业部,2,2993.97,1,126.93,1,"光莆股份,可立克"
1154,华泰证券股份有限公司上海黄河路证券营业部,2,2994.14,2,0.0,0,"中成股份,微光股份"
1155,东兴证券股份有限公司杭州凤起路证券营业部,1,746.43,1,0.0,0,永和智控
1156,国泰君安证券股份有限公司广州人民中路证券营业部,1,672.06,1,0.0,0,永和智控
1157,第一创业证券股份有限公司深圳总部证券营业部,1,0.0,0,609.77,1,微光股份
1158,光大证券股份有限公司广州林和西路证券营业部,4,1655.99,3,725.87,1,"航天机电,红太阳,永和智控"
1159,广发证券股份有限公司绍兴中兴中路证券营业部,1,0.0,0,404.85,1,微光股份
1160,华泰证券股份有限公司合肥长江东大街证券营业部,1,0.0,0,342.84,1,微光股份
1161,西藏东方财富证券股份有限公司拉萨察古大道证券营业部,1,0.0,0,1082.61,1,江阴银行
1162,海通证券股份有限公司重庆龙华大道证券营业部,1,0.0,0,910.48,1,江阴银行
1163,国信证券股份有限公司杭州市心中路证券营业部,5,661.48,2,1400.95,3,"*ST中富,云赛智联,江阴银行,"
1164,湘财证券股份有限公司深圳深南大道证券营业部,1,0.0,0,859.5,1,张家港行
1165,中信建投证券股份有限公司安吉天荒坪路证券营业部,2,8868.12,1,640.09,1,"冀东水泥,张家港行"
1166,华泰证券股份有限公司南通环城西路证券营业部,2,1572.3,1,690.87,1,"京汉股份,钧达股份"
1167,东北证券股份有限公司合肥芜湖路证券营业部,1,981.97,1,0.0,0,传艺科技
1168,爱建证券有限责任公司重庆火炬大道证券营业部,2,750.36,2,0.0,0,"传艺科技,先达股份"
1169,山西证券股份有限公司北京太平庄证券营业部,2,888.4,2,0.0,0,"升达林业,传艺科技"
1170,湘财证券股份有限公司岳阳五里牌证券营业部,2,351.28,1,306.65,1,传艺科技
1171,华福证券有限责任公司呼和浩特兴安南路证券营业部,1,0.0,0,691.79,1,银之杰
1172,民生证券股份有限公司河南分公司,1,1567.13,1,0.0,0,嘉寓股份
1173,广发证券股份有限公司合肥长江中路证券营业部,1,0.0,0,453.1,1,银之杰
1174,信达证券股份有限公司郑州文化路证券营业部,1,0.0,0,408.81,1,银之杰
1175,申万宏源证券有限公司南阳新华西路证券营业部,1,1356.24,1,0.0,0,嘉寓股份
1176,英大证券有限责任公司南京汉中路证券营业部,1,0.0,0,1626.62,1,嘉寓股份
1177,南京证券股份有限公司广州体育西路证券营业部,1,0.0,0,847.25,1,嘉寓股份
1178,华泰证券股份有限公司南京解放路证券营业部,2,588.65,1,652.86,1,"清源股份,嘉寓股份"
1179,长江证券股份有限公司重庆聚贤岩证券营业部,3,3858.34,2,2590.9,1,"太空板业,中航黑豹"
1180,英大证券有限责任公司横岗证券营业部,1,2043.33,1,0.0,0,太空板业
1181,光大证券股份有限公司重庆大坪正街证券营业部,3,2473.76,2,1530.93,1,"太空板业,航发动力"
1182,国融证券股份有限公司上海世纪大道证券营业部,1,0.0,0,8069.66,1,太空板业
1183,广发证券股份有限公司上海天山路证券营业部,1,0.0,0,3761.39,1,太空板业
1184,光大证券股份有限公司上海人民北路证券营业部,1,0.0,0,3102.41,1,太空板业
1185,新时代证券股份有限公司上海金桥路证券营业部,2,0.0,0,3975.34,2,"太空板业,太极实业"
1186,中国银河证券股份有限公司烟台证券营业部,1,0.0,0,4.05,1,友讯达
1187,国联证券股份有限公司无锡中山路证券营业部,2,0.0,0,6.53,2,友讯达
1188,湘财证券股份有限公司长沙芙蓉中路证券营业部,1,1241.71,1,0.0,0,濮阳惠成
1189,东吴证券股份有限公司江阴长江路证券营业部,2,0.0,0,1384.66,2,"陕西金叶,三德科技"
1190,华融证券股份有限公司成都交子大道证券营业部,1,0.0,0,486.27,1,三德科技
1191,西藏东方财富证券股份有限公司北京平原里证券营业部,1,0.0,0,569.52,1,陇神戎发
1192,国信证券股份有限公司深圳南山科苑北路证券营业部,1,0.0,0,548.84,1,陇神戎发
1193,华泰证券股份有限公司浙江分公司,2,1185.34,1,552.3,1,"横河模具,龙蟠科技"
1194,国泰君安证券股份有限公司顺德大良证券营业部,2,5799.49,2,0.0,0,"津膜科技,横河模具"
1195,东兴证券股份有限公司武汉台北一路证券营业部,1,912.12,1,0.0,0,横河模具
1196,国融证券股份有限公司北京北辰东路证券营业部,1,0.0,0,473.6,1,横河模具
1197,东兴证券股份有限公司晋江和平路证券营业部,1,0.0,0,452.29,1,横河模具
1198,广发证券股份有限公司南宁凤翔路证券营业部,1,0.0,0,447.58,1,横河模具
1199,中航证券有限公司长沙韶山中路证券营业部,1,0.0,0,403.14,1,横河模具
1200,中国民族证券有限责任公司北京西坝河证券营业部,2,531.91,1,474.52,1,三超新材
1201,财富证券有限责任公司长沙八一路证券营业部,1,288.25,1,0.0,0,光莆股份
1202,申万宏源西部证券有限公司库尔勒滨河路证券营业部,2,636.33,1,291.98,1,"星云股份,光莆股份"
1203,长城证券股份有限公司成都天晖中街证券营业部,1,0.0,0,1063.47,1,长川科技
1204,安信证券股份有限公司广州花蕾路证券营业部,2,498.71,1,500.32,1,星云股份
1205,上海证券有限责任公司妙境路证券营业部,1,0.0,0,355.55,1,正元智慧
1206,联储证券有限责任公司郑州丰产路证券营业部,1,0.0,0,1.24,1,奥翔药业
1207,方正证券股份有限公司南京文澜路证券营业部,1,15.69,1,0.0,0,韦尔股份
1208,安信证券股份有限公司汕头红领巾路证券营业部,1,0.0,0,1.24,1,奥翔药业
1209,浙商证券股份有限公司衢州荷花中路证券营业部,1,0.0,0,1.48,1,韦尔股份
1210,方正证券股份有限公司贵阳中华中路证券营业部,1,0.0,0,1.24,1,奥翔药业
1211,财达证券股份有限公司天津江都路证券营业部,1,0.0,0,1.24,1,奥翔药业
1212,国金证券股份有限公司都江堰都江大道证券营业部,1,0.0,0,1.48,1,韦尔股份
1213,恒泰证券股份有限公司呼和浩特乌兰察布东街证券营业部,1,0.0,0,1.48,1,韦尔股份
1214,中国银河证券股份有限公司上海五莲路证券营业部,1,0.0,0,1.48,1,韦尔股份
1215,兴业证券股份有限公司客户资产管理部,2,10709.24,2,0.0,0,航天机电
1216,广发证券股份有限公司广州番禺环城东路证券营业部,1,513.12,1,0.0,0,航天机电
1217,中信证券股份有限公司四川分公司,3,0.0,0,8084.38,3,"迪贝电气,航天机电"
1218,爱建证券有限责任公司上海安国路证券营业部,1,1763.66,1,0.0,0,仰帆控股
1219,中银国际证券有限责任公司深圳彩田路证券营业部,1,431.07,1,0.0,0,仰帆控股
1220,申万宏源证券有限公司温州车站大道证券营业部,2,491.91,2,0.0,0,"中科创达,仰帆控股"
1221,中信证券(山东)有限责任公司青岛秦岭路证券营业部,1,0.0,0,1172.5,1,仰帆控股
1222,国元证券股份有限公司大连黄河路证券营业部,1,0.0,0,2794.48,1,太极实业
1223,东方证券股份有限公司成都建设路证券营业部,1,0.0,0,1052.11,1,仰帆控股
1224,海通证券股份有限公司苏州南园北路证券营业部,1,0.0,0,1359.75,1,太极实业
1225,招商证券股份有限公司深圳深南东路证券营业部,1,0.0,0,943.29,1,仰帆控股
1226,新时代证券股份有限公司北京东三环北路证券营业部,1,0.0,0,496.01,1,仰帆控股
1227,国泰君安证券股份有限公司潮州绿榕路证券营业部,1,0.0,0,1048.52,1,太极实业
1228,山西证券股份有限公司太原府西街证券营业部,2,2950.31,1,5520.04,1,航发动力
1229,开源证券股份有限公司西安长安南路证券营业部,1,1665.16,1,0.0,0,航发动力
1230,兴业证券股份有限公司上海金陵东路证券营业部,2,2300.86,1,2073.43,1,吴江银行
1231,国泰君安证券股份有限公司总部,4,642.06,3,6.5,1,"风神股份,寿仙谷,铁流股份,"
1232,招商证券股份有限公司上海牡丹江路证券营业部,2,0.0,0,4.6,2,"铁流股份,寿仙谷"
1233,国泰君安证券股份有限公司客户资产管理部,1,0.0,0,1.66,1,寿仙谷
1234,东吴证券股份有限公司昆山高新区前进西路证券营业部,1,0.0,0,1.66,1,寿仙谷
1235,东北证券股份有限公司吉林遵义东路证券营业部,1,0.0,0,1.66,1,寿仙谷
1236,申万宏源证券有限公司国际部,1,1177.36,1,0.0,0,清源股份
1237,海通证券股份有限公司成都人民西路营业部,1,948.55,1,0.0,0,清源股份
1238,国泰君安证券股份有限公司南昌象山北路证券营业部,1,1421.48,1,0.0,0,银龙股份
1239,爱建证券有限责任公司武汉公正路证券营业部,1,0.0,0,2026.02,1,银龙股份
1240,信达证券股份有限公司营口营港路证券营业部,1,34.99,1,0.0,0,铁流股份
1241,中泰证券股份有限公司济南第一大道证券营业部,1,0.0,0,2.94,1,铁流股份
1242,华泰证券股份有限公司上海西藏南路证券营业部,1,0.0,0,2.94,1,铁流股份
1243,东海证券股份有限公司偃师华夏路证券营业部,1,0.0,0,2.94,1,铁流股份
1244,湘财证券股份有限公司杭州文二西路证券营业部,1,0.0,0,2.94,1,铁流股份
1245,宏信证券有限责任公司成都人民南路证券营业部,1,12.18,1,0.0,0,韦尔股份
1246,海通证券股份有限公司武汉赵家条证券营业部,1,380.17,1,0.0,0,新日股份
1247,德邦证券股份有限公司上海凉城路证券营业部,2,101.38,1,3.4,1,"迪贝电气,太龙照明"
1248,中航证券有限公司郑州嵩山南路证券营业部,1,0.0,0,5.06,1,迪贝电气
1249,申万宏源西部证券有限公司克拉玛依准噶尔路证券营业部,1,0.0,0,2.53,1,迪贝电气
1250,东吴证券股份有限公司吴江平望证券营业部,1,88.29,1,0.0,0,茂业商业
1251,中泰证券股份有限公司长沙万家丽路证券营业部,1,83.9,1,0.0,0,茂业商业
1252,招商证券股份有限公司上海世纪大道证券营业部,2,38.59,1,584.67,1,"力盛赛车,茂业商业"
1253,海通证券股份有限公司青岛九水东路证券营业部,1,28.86,1,0.0,0,茂业商业
1254,东方证券股份有限公司,1,12714.3,1,0.0,0,鹏博士
1255,德邦证券股份有限公司,1,1026.38,1,0.0,0,鹏博士
1256,中国中投证券有限责任公司成都琉璃路华润广场证券营业部,1,0.0,0,140.28,1,茂业商业
1257,西藏东方财富证券股份有限公司,1,782.53,1,0.0,0,鹏博士
1258,申万宏源证券有限公司,1,188.2,1,0.0,0,鹏博士
1259,华泰证券股份有限公司北京月坛南街证券营业部,1,3014.66,1,0.0,0,八一钢铁
1260,财通证券股份有限公司杭州文二西路证券营业部,1,0.0,0,1.36,1,奥翔药业
1261,申万宏源西部证券有限公司乌鲁木齐新华南路证券营业部,1,0.0,0,0.96,1,金石资源
1262,国泰君安证券股份有限公司芒市阔时路证券营业部,1,0.0,0,1.36,1,奥翔药业
1263,平安证券股份有限公司浙江分公司,1,0.0,0,0.96,1,金石资源
1264,广发证券股份有限公司上海东方路证券营业部,1,937.99,1,0.0,0,连云港
1265,长江证券股份有限公司武汉蔡甸大街证券营业部,2,1563.02,2,0.0,0,风神股份
1266,德邦证券股份有限公司沈阳文化路证券营业部,1,348.4,1,0.0,0,风神股份
1267,中国银河证券股份有限公司海口滨海大道证券营业部,1,262.47,1,0.0,0,风神股份
1268,安信证券股份有限公司北京东升科技园证券营业部,1,0.0,0,563.82,1,风神股份
1269,中国银河证券股份有限公司长沙解放中路证券营业部,1,0.0,0,376.88,1,风神股份
1270,财达证券股份有限公司石家庄裕华西路证券营业部,1,0.0,0,233.91,1,风神股份
1271,国泰君安证券股份有限公司平顶山长安大道证券营业部,1,573.8,1,0.0,0,龙蟠科技
1272,东海证券股份有限公司南京长江路证券营业部,1,1195.74,1,0.0,0,茂业商业
1273,国都证券股份有限公司成都天益街证券营业部,1,1144.92,1,0.0,0,茂业商业
1274,光大证券股份有限公司上海张杨路证券营业部（原上海浦东南路证券营业部）,2,0.0,0,3343.56,2,"焦作万方,龙蟠科技"
1275,东方证券股份有限公司温州信河街证券营业部,1,655.88,1,0.0,0,茂业商业
1276,国联证券股份有限公司上海邯郸路证券营业部,1,552.53,1,0.0,0,茂业商业
1277,中国银河证券股份有限公司杭州艮山西路证券营业部,1,0.0,0,549.38,1,龙蟠科技
1278,中信证券（山东）有限责任公司青岛总部证券营业部,2,0.0,0,1602.37,2,"博深工具,中持股份"
1279,国海证券股份有限公司福州五四路证券营业部,1,683.6,1,0.0,0,南宁百货
1280,光大证券股份有限公司东莞运河东一路证券营业部,1,252.6,1,0.0,0,南宁百货
1281,华安证券股份有限公司明光明珠大道证券营业部,1,156.97,1,0.0,0,南宁百货
1282,浙商证券股份有限公司南宁金湖路证券营业部,1,152.15,1,0.0,0,南宁百货
1283,信达证券股份有限公司厦门分公司,1,0.0,0,873.52,1,南宁百货
1284,光大证券股份有限公司深圳新园路营业部,2,0.0,0,1437.17,2,"风神股份,南宁百货"
1285,中泰证券股份有限公司大连鲁迅路证券营业部,2,908.59,1,956.98,1,中航黑豹
1286,国盛证券有限责任公司福州福马路证券营业部,1,0.0,0,506.12,1,南宁百货
1287,国海证券股份有限公司梧州大学路证券营业部,1,0.0,0,437.47,1,南宁百货
1288,国盛证券有限责任公司武汉京汉大道证券营业部,1,0.0,0,1993.35,1,中航黑豹
1289,国海证券股份有限公司客户资产管理部,1,0.0,0,387.81,1,南宁百货
1290,中原证券股份有限公司洛阳分公司,1,0.0,0,986.99,1,中航黑豹
1291,中银国际证券有限责任公司大连黄河路证券营业部,1,0.0,0,561.73,1,中航黑豹
1292,华鑫证券有限责任公司广州广州大道中证券营业部,1,0.21,1,0.0,0,先达股份
1293,上海证券有限责任公司堡镇证券营业部,1,0.0,0,2.54,1,先达股份
1294,海通证券股份有限公司大连天津街证券营业部,1,0.0,0,2.54,1,先达股份
1295,国联证券股份有限公司无锡新区长江北路证券营业部,1,0.0,0,2.54,1,先达股份
1296,西南证券股份有限公司上海普陀区平利路证券营业部,1,0.0,0,2.54,1,先达股份
1297,爱建证券有限责任公司上海曲阳路证券营业部,1,53.44,1,0.0,0,金能科技
1298,国信证券股份有限公司重庆红锦大道证券营业部,2,0.16,1,0.95,1,"金能科技,杭州园林"
1299,光大证券股份有限公司北京月坛北街证券营业部,1,0.0,0,2.89,1,金能科技
1300,英大证券有限责任公司深圳华侨城证券营业部,1,0.0,0,1.93,1,金能科技
1301,万联证券有限责任公司广州东风中路证券营业部,1,1238.04,1,0.0,0,博天环境
1302,中国国际金融股份有限公司大连港兴路证券营业部,1,873.17,1,0.0,0,吴江银行
1303,海通证券股份有限公司安庆湖心北路证券营业部,1,0.0,0,431.7,1,博天环境
1304,东北证券股份有限公司上海洪山路证券营业部,1,830.37,1,0.0,0,吴江银行
1305,华泰证券股份有限公司南京止马营证券营业部,1,758.1,1,0.0,0,吴江银行
1306,国泰君安证券股份有限公司上海九江路证券营业部,1,0.0,0,964.42,1,博天环境
1307,国泰君安证券股份有限公司扬州扬子江中路证券营业部,1,0.0,0,802.23,1,博天环境
1308,海通证券股份有限公司徐州中山北路证券营业部,1,42.36,1,0.0,0,鸣志电器
1309,方正证券股份有限公司北京玉带河东街证券营业部,1,24.13,1,0.0,0,金石资源
1310,海通证券股份有限公司太仓人民南路证券营业部,1,15.81,1,0.0,0,鸣志电器
1311,长城证券股份有限公司唐山北新西道证券营业部,1,0.0,0,1.96,1,鸣志电器
1312,国泰君安证券股份有限公司上海松江中山东路证券营业部,1,566.33,1,0.0,0,恒润股份
1313,上海证券有限责任公司乐都路证券营业部,1,0.0,0,1665.51,1,风神股份
1314,申万宏源证券有限公司资产管理事业部,1,0.0,0,663.9,1,风神股份
1315,安信证券股份有限公司汕尾海丰证券营业部,1,993.41,1,0.0,0,柳钢股份
1316,华西证券股份有限公司绵阳安昌路证券营业部,1,565.14,1,0.0,0,航天机电
1317,新时代证券股份有限公司苏州白塔西路证券营业部,1,488.53,1,0.0,0,云赛智联
1318,中泰证券股份有限公司舟山环城西路证券营业部,1,406.03,1,0.0,0,云赛智联
1319,财达证券股份有限公司石家庄广安大街证券营业部,1,247.8,1,0.0,0,云赛智联
1320,中国银河证券股份有限公司上海浦东新区源深路证券营业部,2,1797.99,2,0.0,0,国际医学
1321,国信证券股份有限公司厦门金钟路证券营业部,1,646.21,1,0.0,0,国际医学
1322,国泰君安证券股份有限公司深圳上步中路证券营业部,2,903.72,1,1777.39,1,"钧达股份,红太阳"
1323,国信证券股份有限公司陕西分公司,2,0.0,0,3425.68,2,国际医学
1324,安信证券股份有限公司汕头澄海证券营业部,1,0.0,0,1225.07,1,中成股份
1325,长江证券股份有限公司海南分公司,2,2863.01,1,2375.52,1,冀东水泥
1326,华融证券股份有限公司北京金融大街证券营业部,1,0.0,0,8880.15,1,冀东水泥
1327,招商证券股份有限公司深圳布吉罗岗路证券营业部,1,0.0,0,623.89,1,中成股份
1328,平安证券股份有限公司上海零陵路证券营业部,1,0.0,0,5146.98,1,冀东水泥
1329,平安证券股份有限公司乌鲁木齐人民路证券营业部,1,0.0,0,600.09,1,中成股份
1330,湘财证券股份有限公司福州东街证券营业部,2,1026.16,1,935.08,1,*ST中富
1331,中泰证券股份有限公司杭州求是路证券营业部,2,51.58,1,309.54,1,"北部湾港,*ST中富"
1332,中国民族证券有限责任公司鞍山湖南街证券营业部,1,497.67,1,0.0,0,*ST中富
1333,山西证券股份有限公司太原解放北路证券营业部,1,48.97,1,0.0,0,北部湾港
1334,中信证券股份有限公司上海嘉定证券营业部,1,44.87,1,0.0,0,北部湾港
1335,申万宏源证券有限公司南昌南京东路证券营业部,1,329.42,1,0.0,0,*ST中富
1336,华融证券股份有限公司重庆江北证券营业部,1,0.0,0,201.1,1,北部湾港
1337,华龙证券股份有限公司兰州民主东路证券营业部,1,0.0,0,1179.71,1,*ST中富
1338,中信证券股份有限公司平湖建国北路证券营业部,1,0.0,0,194.39,1,北部湾港
1339,东海证券股份有限公司焦作建设西路证券营业部,1,272.32,1,0.0,0,焦作万方
1340,申万宏源西部证券有限公司天津滨海新区黄海路证券营业部,1,963.06,1,0.0,0,渤海股份
1341,兴业证券股份有限公司青岛分公司,1,208.4,1,0.0,0,焦作万方
1342,中信建投证券股份有限公司上海五莲路证券营业部,1,0.0,0,2778.38,1,焦作万方
1343,东海证券股份有限公司常州通江中路证券营业部,1,0.0,0,363.09,1,焦作万方
1344,万和证券股份有限公司上海分公司,1,672.82,1,0.0,0,陕西金叶
1345,华泰证券股份有限公司深圳龙岗黄阁北路证券营业部,1,536.63,1,0.0,0,石化机械
1346,兴业证券股份有限公司厦门分公司,2,595.22,1,596.78,1,陕西金叶
1347,广发证券股份有限公司郑州农业路营业部,2,568.15,1,529.42,1,陕西金叶
1348,浙商证券股份有限公司郑州黄河路证券营业部,1,3333.31,1,0.0,0,正虹科技
1349,东莞证券股份有限公司厦门枋湖东路证券营业部,1,2490.69,1,0.0,0,正虹科技
1350,中原证券股份有限公司新安磁河路证券营业部,1,1223.64,1,0.0,0,正虹科技
1351,中国民族证券有限责任公司北京彩和坊路证券营业部,1,0.0,0,8148.08,1,冀东装备
1352,华泰证券股份有限公司郑州经三路证券营业部,1,0.0,0,2806.27,1,正虹科技
1353,中信证券（山东）有限责任公司青岛南京路证券营业部,1,196.85,1,0.0,0,升达林业
1354,光大证券股份有限公司上海宝山华和路证券营业部,1,0.0,0,547.7,1,升达林业
1355,中国中投证券有限责任公司晋江迎宾路证券营业部,1,360.32,1,0.0,0,湘潭电化
1356,华创证券有限责任公司贵阳金阳大道证券营业部,1,2415.38,1,0.0,0,信邦制药
1357,中信证券股份有限公司杭州朝晖路证券营业部,1,178.08,1,0.0,0,湘潭电化
1358,招商证券股份有限公司北京光明路证券营业部,2,2290.4,1,2898.01,1,"信邦制药,津膜科技"
1359,方正证券股份有限公司长沙黄兴中路证券营业部,1,173.63,1,0.0,0,湘潭电化
1360,中信证券股份有限公司杭州庆春路证券营业部,1,706.28,1,0.0,0,信邦制药
1361,申万宏源证券有限公司上海闵行区吴中路证券营业部,1,0.0,0,846.41,1,湘潭电化
1362,国融证券股份有限公司成都东大街证券营业部,1,1326.62,1,0.0,0,博深工具
1363,广发证券股份有限公司上海水清南路证券营业部,1,0.0,0,1185.08,1,信邦制药
1364,国元证券股份有限公司宣城叠嶂西路证券营业部,1,1008.19,1,0.0,0,博深工具
1365,申万宏源证券有限公司上海浦东新区临沂路证券营业部,1,200.39,1,0.0,0,达意隆
1366,申万宏源西部证券有限公司乌鲁木齐解放南路证券营业部,1,0.0,0,1075.5,1,博深工具
1367,浙商证券股份有限公司宁波四明中路证券营业部,2,179.31,1,1260.2,1,"达意隆,太空板业"
1368,中原证券股份有限公司西安未央路证券营业部,1,0.0,0,768.63,1,博深工具
1369,安信证券股份有限公司常州延陵东路证券营业部,1,0.0,0,1942.75,1,达意隆
1370,兴业证券股份有限公司台州分公司,1,0.0,0,342.09,1,达意隆
1371,中信证券股份有限公司杭州杭大路证券营业部,1,0.0,0,306.42,1,达意隆
1372,国信证券股份有限公司广州天河北路证券营业部,1,2553.58,1,0.0,0,中泰桥梁
1373,招商证券股份有限公司天津开发区第三大街证券营业部,1,0.0,0,410.75,1,中泰桥梁
1374,广发证券股份有限公司汕头梅溪东路证券营业部,1,0.0,0,355.74,1,中泰桥梁
1375,华林证券股份有限公司宁波惊驾路证券营业部,1,941.27,1,0.0,0,好利来
1376,首创证券有限责任公司宁波日丽中路证券营业部,2,770.15,1,454.56,1,好利来
1377,首创证券有限责任公司重庆渝北区洪湖东路证券营业部,1,598.44,1,0.0,0,好利来
1378,天风证券股份有限公司上海芳甸路证券营业部,3,1846.79,3,0.0,0,"新宏泽,陇神戎发,第一创业"
1379,长江证券股份有限公司慈溪新城大道证券营业部,2,533.4,1,448.22,1,好利来
1380,中航证券有限公司南京中央北路证券营业部,1,367.43,1,0.0,0,好利来
1381,山西证券股份有限公司太原平阳路证券营业部,1,183.2,1,0.0,0,第一创业
1382,中航证券有限公司深圳春风路证券营业部,1,0.0,0,512.35,1,好利来
1383,广发证券股份有限公司上海西藏南路证券营业部,1,135.75,1,0.0,0,第一创业
1384,第一创业证券股份有限公司北京新街口北大街证券营业部,1,0.0,0,10327.4,1,第一创业
1385,万联证券有限责任公司北京上地创业路证券营业部,1,0.0,0,3656.67,1,第一创业
1386,国元证券股份有限公司上海周家嘴路证券营业部,1,589.04,1,0.0,0,新宏泽
1387,中信证券股份有限公司北京天通苑证券营业部,1,0.0,0,766.17,1,新宏泽
1388,国金证券股份有限公司上海浦东新区芳甸路证券营业部,1,1418.24,1,0.0,0,张家港行
1389,东北证券股份有限公司长春西安大路证券营业部,1,857.44,1,0.0,0,力盛赛车
1390,西部证券股份有限公司潍坊东风东街证券营业部,1,519.03,1,0.0,0,力盛赛车
1391,中国银河证券股份有限公司马鞍山湖东中路证券营业部,1,384.15,1,0.0,0,力盛赛车
1392,长江证券股份有限公司成都光华村街证券营业部,1,817.19,1,0.0,0,传艺科技
1393,国泰君安证券股份有限公司上海陆家嘴东路证券营业部,1,744.81,1,0.0,0,传艺科技
1394,方正证券股份有限公司苍南站前大道证券营业部,1,491.06,1,0.0,0,传艺科技
1395,恒泰证券股份有限公司瑞安拱瑞山路证券营业部,1,0.0,0,346.81,1,传艺科技
1396,国泰君安证券股份有限公司临沂沂蒙路证券营业部,1,0.0,0,1.11,1,伟隆股份
1397,申万宏源证券有限公司南京山西路证券营业部,1,0.0,0,1.11,1,伟隆股份
1398,世纪证券有限责任公司赣州金钻广场证券营业部,1,0.0,0,1.11,1,伟隆股份
1399,华鑫证券有限责任公司北京平安大街证券营业部,1,873.94,1,0.0,0,绿康生化
1400,国泰君安证券股份有限公司深圳深南东路证券营业部,1,435.22,1,0.0,0,绿康生化
1401,中国中投证券有限责任公司深圳坪山和平路证券营业部,1,430.96,1,0.0,0,绿康生化
1402,恒泰证券股份有限公司福州北环中路证券营业部,1,327.65,1,0.0,0,海默科技
1403,国联证券股份有限公司北京首体南路证券营业部,1,267.43,1,0.0,0,海默科技
1404,海通证券股份有限公司丹阳东方路证券营业部,1,151.1,1,0.0,0,海默科技
1405,东兴证券股份有限公司福州江厝路证券营业部,1,0.0,0,2723.21,1,海默科技
1406,东方证券股份有限公司南京进香河路证券营业部,1,0.0,0,687.29,1,海默科技
1407,上海证券有限责任公司温州谢池商城证券营业部,1,493.45,1,0.0,0,易华录
1408,中航证券有限公司北京慧忠路证券营业部,1,415.01,1,0.0,0,易华录
1409,信达证券股份有限公司上海灵山路证券营业部,1,0.0,0,1265.08,1,易华录
1410,光大证券股份有限公司西宁黄河路证券营业部,1,0.0,0,660.57,1,易华录
1411,山西证券股份有限公司天津长江道证券营业部,1,0.0,0,27540.0,1,津膜科技
1412,华西证券股份有限公司上海曲阳路证券营业部,2,1583.93,1,531.71,1,"太空板业,浩丰科技"
1413,东方证券股份有限公司上海浦东新区牡丹路证券营业部,1,1197.64,1,0.0,0,太空板业
1414,第一创业证券股份有限公司上海长清路证券营业部,2,498.07,1,824.47,1,恒通科技
1415,申万宏源证券有限公司上海黄浦区陆家浜路证券营业部,2,278.67,1,211.53,1,恒通科技
1416,中信证券股份有限公司北京国贸证券营业部,1,0.0,0,388.6,1,恒通科技
1417,东兴证券股份有限公司北京北四环中路证券营业部,1,3171.92,1,0.0,0,浩丰科技
1418,中国银河证券股份有限公司石家庄红旗大街证券营业部,1,1254.11,1,0.0,0,浩丰科技
1419,恒泰证券股份有限公司广州珠江西路证券营业部,1,639.07,1,0.0,0,浩丰科技
1420,中银国际证券有限责任公司石家庄新华路证券营业部,1,478.67,1,0.0,0,浩丰科技
1421,东莞证券股份有限公司东莞凤岗证券营业部,1,0.0,0,910.88,1,浩丰科技
1422,上海证券有限责任公司瑞安罗阳大道证券营业部,1,144.56,1,0.0,0,高伟达
1423,华安证券股份有限公司淮南朝阳西路证券营业部,1,131.74,1,0.0,0,高伟达
1424,安信证券股份有限公司北京中关村南大街证券营业部,1,0.0,0,2552.66,1,高伟达
1425,长江证券股份有限公司济南经十路证券营业部,1,0.0,0,1078.95,1,高伟达
1426,东吴证券股份有限公司昆山环城北路证券营业部,1,0.0,0,3.16,1,友讯达
1427,中信证券股份有限公司金华中山路证券营业部,1,0.0,0,290.88,1,高伟达
1428,东海证券股份有限公司上海长顺路证券营业部,1,0.0,0,188.28,1,高伟达
1429,东兴证券股份有限公司新疆分公司,1,0.0,0,3.16,1,友讯达
1430,光大证券股份有限公司昆明人民中路证券营业部,1,292.89,1,0.0,0,中科创达
1431,上海证券有限责任公司深圳福虹路证券营业部,1,0.0,0,847.38,1,中科创达
1432,浙商证券股份有限公司湖州双子大厦证券营业部,3,3949.41,3,0.0,0,"陇神戎发,乐心医疗"
1433,宏信证券有限责任公司上海崂山东路证券营业部,1,15.85,1,0.0,0,万通智控
1434,招商证券股份有限公司晋江和平中路证券营业部,1,7.09,1,0.0,0,万通智控
1435,广发证券股份有限公司惠州下埔路证券营业部,1,0.0,0,0.87,1,万通智控
1436,安信证券股份有限公司韶关曲江韶钢大道证券营业部,1,0.0,0,0.45,1,万通智控
1437,长城证券股份有限公司西安沣镐东路证券营业部,1,0.0,0,0.45,1,万通智控
1438,广发证券股份有限公司江门万达广场证券营业部,2,3437.26,1,625.93,1,乐心医疗
1439,长江证券股份有限公司南昌赣江中大道证券营业部,1,0.0,0,0.45,1,万通智控
1440,华泰证券股份有限公司深圳竹子林四路证券营业部,1,20.18,1,0.0,0,超频三
1441,安信证券股份有限公司北京复兴门外大街证券营业部,1,0.0,0,1.14,1,超频三
1442,财富证券有限责任公司长沙曙光中路证券营业部,1,0.0,0,1.14,1,超频三
1443,长城证券股份有限公司武汉云林街证券营业部,1,0.0,0,1.14,1,超频三
1444,中泰证券股份有限公司厦门嘉禾路证券营业部,1,649.09,1,0.0,0,三超新材
1445,海通证券股份有限公司西安西新街证券营业部,1,444.01,1,0.0,0,三超新材
1446,中信证券股份有限公司苏州苏雅路证券营业部,1,0.0,0,277.94,1,三超新材
1447,华创证券有限责任公司六枝那平路证券营业部,1,0.0,0,0.95,1,杭州园林
1448,华龙证券股份有限公司兰州七里河证券营业部,1,0.0,0,0.95,1,杭州园林
1449,华融证券股份有限公司上海华山路证券营业部,1,0.0,0,0.95,1,杭州园林
1450,华安证券股份有限公司合肥长江中路证券营业部,1,0.0,0,3.2,1,太龙照明
1451,渤海证券股份有限公司上海虹口区大连路证券营业部,1,0.0,0,1.78,1,太龙照明
1452,广发证券股份有限公司北京阜成门南大街证券营业部,1,0.0,0,2.43,1,太龙照明
1453,国都证券股份有限公司上海长阳路证券营业部,1,0.0,0,1.19,1,金陵体育
1454,平安证券股份有限公司四川分公司,1,0.0,0,1.19,1,金陵体育
1455,中国银河证券股份有限公司上海中山北路证券营业部,1,0.0,0,1.19,1,金陵体育
1456,长江证券股份有限公司宜昌云集路证券营业部,1,0.0,0,1.09,1,金陵体育
