,stockCode,securityAbbr,rzmre,rzye,rqmcl,rqyl,rqye,rzrqye,opDate
0,000001,平安银行,67509258,3568650256,29700,876908,8032477,3576682733,2017-01-03
1,000002,万 科Ａ,83015991,2302578467,90836,786755,16309431,2318887898,2017-01-03
2,000006,深振业Ａ,77960220,1537562412,214000,334010,3229877,1540792289,2017-01-03
3,000009,中国宝安,67539347,2921259423,45300,417305,4365010,2925624433,2017-01-03
4,000012,南 玻Ａ,52880355,1461755667,0,62300,710220,1462465887,2017-01-03
5,000022,深赤湾Ａ,18424391,104967762,50900,70200,1356966,106324728,2017-01-03
6,000027,深圳能源,5730941,544038802,0,20923,144787,544183589,2017-01-03
7,000028,国药一致,6222267,144846554,0,4600,310040,145156594,2017-01-03
8,000030,富奥股份,4552038,19004811,0,0,0,19004811,2017-01-03
9,000031,中粮地产,16664690,1007968699,20000,25000,225500,1008194199,2017-01-03
10,000039,中集集团,9503165,1013452135,0,105835,1566358,1015018493,2017-01-03
11,000043,中航地产,75972764,584704845,0,0,0,584704845,2017-01-03
12,000046,泛海控股,5848086,563372755,5000,86600,811442,564184197,2017-01-03
13,000049,德赛电池,37156924,481277971,10200,13248,535087,481813058,2017-01-03
14,000050,深天马Ａ,0,1025656111,0,3000,56460,1025712571,2017-01-03
15,000060,中金岭南,42514027,1571703768,500,298000,3364420,1575068188,2017-01-03
16,000061,农 产 品,13645516,1105704193,10000,28700,361620,1106065813,2017-01-03
17,000062,深圳华强,28990511,813023195,400,1600,45264,813068459,2017-01-03
18,000063,中兴通讯,65244811,2633055236,16400,206990,3353238,2636408474,2017-01-03
19,000069,华侨城Ａ,60435360,1397391017,34700,549341,3828906,1401219923,2017-01-03
20,000078,海王生物,15911950,943262363,0,54350,344579,943606942,2017-01-03
21,000088,盐 田 港,5366018,356676949,60700,75600,545832,357222781,2017-01-03
22,000089,深圳机场,3910242,426749507,700,35000,288400,427037907,2017-01-03
23,000099,中信海直,57573558,620597187,0,0,0,620597187,2017-01-03
24,000100,TCL 集团,61318117,1598271097,1468500,1528700,5243441,1603514538,2017-01-03
25,000151,中成股份,51294701,732845890,58500,73447,1455720,734301610,2017-01-03
26,000156,华数传媒,14134021,979303833,0,5600,101024,979404857,2017-01-03
27,000157,中联重科,31204346,1053434911,0,175200,795408,1054230319,2017-01-03
28,000166,申万宏源,0,111426149,0,16500,103125,111529274,2017-01-03
29,000333,美的集团,124415578,1830193479,243100,466800,13593216,1843786695,2017-01-03
30,000338,潍柴动力,19725249,1103449553,43460,4177848,41653144,1145102697,2017-01-03
31,000400,许继电气,27745613,648268286,54500,137149,2545485,650813771,2017-01-03
32,000401,冀东水泥,9442859,364501416,2200,140400,1718496,366219912,2017-01-03
33,000402,金 融 街,9806423,1124615655,1000,144000,1509120,1126124775,2017-01-03
34,000404,华意压缩,12343624,84133010,0,0,0,84133010,2017-01-03
35,000410,沈阳机床,7589975,952175244,0,0,0,952175244,2017-01-03
36,000413,东旭光电,122635213,3560397267,368600,890300,10149420,3570546687,2017-01-03
37,000415,渤海金控,15394341,890152303,0,88600,643236,890795539,2017-01-03
38,000417,合肥百货,13932800,644055404,0,0,0,644055404,2017-01-03
39,000418,小天鹅Ａ,1531079,31117519,0,0,0,31117519,2017-01-03
40,000422,湖北宜化,20801111,474540133,35000,95500,778325,475318458,2017-01-03
41,000423,东阿阿胶,21515429,1517724143,2900,36600,1992870,1519717013,2017-01-03
42,000425,徐工机械,41782362,984276578,240000,1200000,4068000,988344578,2017-01-03
43,000426,兴业矿业,8656810,661436936,0,100,885,661437821,2017-01-03
44,000488,晨鸣纸业,53679188,393760675,50000,130000,1392300,395152975,2017-01-03
45,000501,鄂武商Ａ,13972081,503095493,0,0,0,503095493,2017-01-03
46,000503,海虹控股,31016013,3428405200,12200,157600,6634960,3435040160,2017-01-03
47,000506,中润资源,183304675,906334417,1000,10100,111504,906445921,2017-01-03
48,000513,丽珠集团,7361762,207254406,0,6607,395099,207649505,2017-01-03
49,000516,国际医学,0,1240503728,0,0,0,1240503728,2017-01-03
50,000525,红 太 阳,12623304,384608832,0,0,0,384608832,2017-01-03
51,000528,柳 工,16425951,413203251,0,2100,15540,413218791,2017-01-03
52,000536,华映科技,15792521,580670631,0,0,0,580670631,2017-01-03
53,000537,广宇发展,18329694,574353968,0,0,0,574353968,2017-01-03
54,000538,云南白药,182813970,954629227,89850,111637,8224298,962853525,2017-01-03
55,000539,粤电力Ａ,2978184,349804268,0,4700,25333,349829601,2017-01-03
56,000540,中天城投,85511670,1077285231,15000,72401,510427,1077795658,2017-01-03
57,000541,佛山照明,14646035,701780151,22700,30000,295800,702075951,2017-01-03
58,000543,皖能电力,14585400,1029121243,0,50000,383000,1029504243,2017-01-03
59,000550,江铃汽车,6933197,112779343,0,0,0,112779343,2017-01-03
60,000551,创元科技,18018116,581860952,0,0,0,581860952,2017-01-03
61,000552,靖远煤电,2805086,397340596,0,0,0,397340596,2017-01-03
62,000554,泰山石油,56975219,636154032,35000,35000,400750,636554782,2017-01-03
63,000559,万向钱潮,22343123,1666773844,1400,144080,1922027,1668695871,2017-01-03
64,000563,陕国投Ａ,0,577404984,0,1800,13464,577418448,2017-01-03
65,000566,海南海药,7590777,1212361909,0,67300,856729,1213218638,2017-01-03
66,000568,泸州老窖,8489341,583063303,0,109017,3619365,586682668,2017-01-03
67,000572,海马汽车,27506406,608845522,0,0,0,608845522,2017-01-03
68,000581,威孚高科,7231688,665364935,2500,48800,1099952,666464887,2017-01-03
69,000592,平潭发展,13647750,1175211917,0,19900,136116,1175348033,2017-01-03
70,000596,古井贡酒,9253464,162527928,4800,11300,516636,163044564,2017-01-03
71,000598,兴蓉环境,15914908,964033447,0,101100,589413,964622860,2017-01-03
72,000600,建投能源,8486071,65192773,0,0,0,65192773,2017-01-03
73,000607,华媒控股,44841170,466238842,20000,20000,234200,466473042,2017-01-03
74,000616,海航投资,7774972,1026485047,0,7700,40656,1026525703,2017-01-03
75,000623,吉林敖东,132967186,2487106196,6700,586768,18254352,2505360548,2017-01-03
76,000625,长安汽车,52197383,1898379818,3000,33700,508870,1898888688,2017-01-03
77,000630,铜陵有色,34735786,1130067841,64900,676200,2136792,1132204633,2017-01-03
78,000631,顺发恒业,7344205,328987775,0,1836,8923,328996698,2017-01-03
79,000650,仁和药业,13739248,765631459,0,18400,130272,765761731,2017-01-03
80,000651,格力电器,201230237,5508423064,31900,301114,7545917,5515968981,2017-01-03
81,000655,金岭矿业,27703768,384621175,0,1400,13790,384634965,2017-01-03
82,000656,金科股份,19739768,250900569,0,50000,262000,251162569,2017-01-03
83,000661,长春高新,107300940,1218063490,4400,5704,644552,1218708042,2017-01-03
84,000665,湖北广电,5644748,39765492,0,0,0,39765492,2017-01-03
85,000667,美好置业,3645498,584159118,44800,70800,264084,584423202,2017-01-03
86,000671,阳 光 城,13771312,594621262,200,1500,8370,594629632,2017-01-03
87,000680,山推股份,14587956,605961243,14000,19000,106210,606067453,2017-01-03
88,000685,中山公用,23789953,572382652,26400,72000,802800,573185452,2017-01-03
89,000686,东北证券,64430183,2465427609,0,17700,221781,2465649390,2017-01-03
90,000690,宝新能源,0,736455764,0,75200,697104,737152868,2017-01-03
91,000697,炼石有色,0,1492426349,0,14488,340613,1492766962,2017-01-03
92,000700,模塑科技,4528697,41551390,0,0,0,41551390,2017-01-03
93,000709,河钢股份,40348278,907148844,65400,2683300,8935389,916084233,2017-01-03
94,000712,锦龙股份,85532074,2040678228,4600,58600,1382960,2042061188,2017-01-03
95,000718,苏宁环球,25658919,965226367,200,33250,285617,965511984,2017-01-03
96,000719,大地传媒,11438252,141689570,0,5600,65744,141755314,2017-01-03
97,000725,京东方Ａ,579077510,4063085805,1158500,3340800,10356480,4073442285,2017-01-03
98,000726,鲁 泰Ａ,27782604,120293691,0,0,0,120293691,2017-01-03
99,000728,国元证券,127901432,3479078482,193400,1042218,21261247,3500339729,2017-01-03
100,000729,燕京啤酒,4259566,506245275,0,19200,134784,506380059,2017-01-03
101,000731,四川美丰,56798069,994734322,215000,309974,3195832,997930154,2017-01-03
102,000732,泰禾集团,9937222,520357077,12400,32900,585620,520942697,2017-01-03
103,000738,中航动控,84355804,1133343741,187300,353290,9005362,1142349103,2017-01-03
104,000739,普洛药业,1021328,332687725,0,0,0,332687725,2017-01-03
105,000750,国海证券,0,2355006044,0,4850,33805,2355039849,2017-01-03
106,000758,中色股份,20216213,944802792,0,20000,161800,944964592,2017-01-03
107,000761,本钢板材,3914233,226615720,0,0,0,226615720,2017-01-03
108,000762,西藏矿业,14073263,1078777697,0,13000,223080,1079000777,2017-01-03
109,000767,漳泽电力,8815831,27029465,0,0,0,27029465,2017-01-03
110,000768,中航飞机,126023553,1598174173,443167,843719,18679939,1616854112,2017-01-03
111,000776,广发证券,58572833,2703008166,4000,123008,2104667,2705112833,2017-01-03
112,000777,中核科技,30245325,811247474,57000,65000,1469000,812716474,2017-01-03
113,000778,新兴铸管,53845330,1069406633,19800,209500,1091495,1070498128,2017-01-03
114,000780,平庄能源,10755821,396746668,0,0,0,396746668,2017-01-03
115,000783,长江证券,40621688,2612642083,173600,889400,9223078,2621865161,2017-01-03
116,000786,北新建材,15252830,428220923,25400,54400,566304,428787227,2017-01-03
117,000788,北大医药,9371282,399220187,0,0,0,399220187,2017-01-03
118,000789,万年青,21365096,264682978,0,600,4854,264687832,2017-01-03
119,000790,泰合健康,6413044,846392944,0,34,453,846393397,2017-01-03
120,000792,盐湖股份,57105853,1054962508,36900,44800,878976,1055841484,2017-01-03
121,000793,华闻传媒,39481394,2079510882,0,164700,1870992,2081381874,2017-01-03
122,000800,一汽轿车,18056377,950009988,64200,241400,2648158,952658146,2017-01-03
123,000801,四川九洲,16982186,497673025,0,36000,390600,498063625,2017-01-03
124,000807,云铝股份,18402482,595957564,0,4800,32352,595989916,2017-01-03
125,000811,烟台冰轮,18605332,462522118,2700,2700,40446,462562564,2017-01-03
126,000812,陕西金叶,59159123,534422947,15000,47565,579817,535002764,2017-01-03
127,000816,智慧农业,20414893,743322775,0,500,3245,743326020,2017-01-03
128,000823,超声电子,25344680,814857056,0,0,0,814857056,2017-01-03
129,000825,太钢不锈,5784780,687554860,0,46900,186662,687741522,2017-01-03
130,000826,启迪桑德,13756336,1431211076,2100,79635,2622381,1433833457,2017-01-03
131,000828,东莞控股,13622675,134313615,0,20000,253600,134567215,2017-01-03
132,000829,天音控股,0,623424126,0,0,0,623424126,2017-01-03
133,000830,鲁西化工,21264710,589908808,0,500,2820,589911628,2017-01-03
134,000839,中信国安,68248056,3354179319,79200,379785,3516809,3357696128,2017-01-03
135,000848,承德露露,8115467,372443310,0,90500,1023555,373466865,2017-01-03
136,000851,高鸿股份,16967617,1035122072,0,11500,138000,1035260072,2017-01-03
137,000858,五 粮 液,59713311,1738526369,12400,181500,6290790,1744817159,2017-01-03
138,000860,顺鑫农业,100412783,583395218,0,8498,184577,583579795,2017-01-03
139,000868,安凯客车,9089481,451659774,0,0,0,451659774,2017-01-03
140,000869,张 裕Ａ,4928513,216051069,0,12200,443226,216494295,2017-01-03
141,000876,新 希 望,13851045,952093919,0,278870,2264424,954358343,2017-01-03
142,000877,天山股份,13510017,518440142,0,0,0,518440142,2017-01-03
143,000878,云南铜业,54041496,922405711,102500,119000,1432760,923838471,2017-01-03
144,000883,湖北能源,10476381,521699587,0,415700,1924691,523624278,2017-01-03
145,000887,中鼎股份,0,2408173526,0,39200,1016848,2409190374,2017-01-03
146,000895,双汇发展,12858366,686735408,24200,111409,2344045,689079453,2017-01-03
147,000897,津滨发展,11993299,424381074,0,0,0,424381074,2017-01-03
148,000898,鞍钢股份,22195307,315082264,24600,57000,288990,315371254,2017-01-03
149,000899,赣能股份,6375296,30725813,0,0,0,30725813,2017-01-03
150,000900,现代投资,9758668,49729875,0,0,0,49729875,2017-01-03
151,000901,航天科技,86290024,752038861,8300,9097,321215,752360076,2017-01-03
152,000902,新洋丰,15359200,88453440,0,0,0,88453440,2017-01-03
153,000905,厦门港务,10344392,374372351,0,0,0,374372351,2017-01-03
154,000915,山大华特,10888463,484960845,0,1000,43790,485004635,2017-01-03
155,000917,电广传媒,40184149,2568134752,0,123777,1787340,2569922092,2017-01-03
156,000921,海信科龙,9411830,279069730,0,0,0,279069730,2017-01-03
157,000926,福星股份,15138157,897784098,0,86,1092,897785190,2017-01-03
158,000928,中钢国际,29459358,94845600,0,0,0,94845600,2017-01-03
159,000930,中粮生化,101247128,1048404736,93700,203302,2787270,1051192006,2017-01-03
160,000937,冀中能源,28518571,571701860,31400,96500,653305,572355165,2017-01-03
161,000938,紫光股份,7165046,1278314767,2100,8112,466764,1278781531,2017-01-03
162,000939,凯迪生态,113401229,1261891946,0,85000,1091400,1262983346,2017-01-03
163,000957,中通客车,13439054,175856083,0,0,0,175856083,2017-01-03
164,000960,锡业股份,39338166,1584321224,9100,23800,319158,1584640382,2017-01-03
165,000961,中南建设,51622626,819789750,37700,144250,1543475,821333225,2017-01-03
166,000963,华东医药,9034974,371942100,300,25768,1868438,373810538,2017-01-03
167,000966,长源电力,4273421,38752874,0,0,0,38752874,2017-01-03
168,000969,安泰科技,17135380,862937495,0,20300,215789,863153284,2017-01-03
169,000970,中科三环,19513713,1732446350,7800,23300,315948,1732762298,2017-01-03
170,000973,佛塑科技,7041067,813208419,0,0,0,813208419,2017-01-03
171,000975,银泰资源,27037502,440699779,0,59700,925350,441625129,2017-01-03
172,000977,浪潮信息,44967711,1655723372,32900,55196,1172363,1656895735,2017-01-03
173,000979,中弘股份,16850820,766704075,0,26600,70490,766774565,2017-01-03
174,000983,西山煤电,33723076,922450139,53800,111200,952984,923403123,2017-01-03
175,000988,华工科技,23779267,1334241239,0,39676,625294,1334866533,2017-01-03
176,000989,九 芝 堂,1764691,721486642,0,3105,67627,721554269,2017-01-03
177,000996,中国中期,53374346,944213481,36000,46000,1122400,945335881,2017-01-03
178,000997,新 大 陆,195224534,1372321327,132700,160000,3272000,1375593327,2017-01-03
179,000998,隆平高科,53314879,773492010,82108,222208,4861911,778353921,2017-01-03
180,000999,华润三九,16555657,390897870,1500,41753,1042572,391940442,2017-01-03
181,001896,豫能控股,36017595,185505206,0,0,0,185505206,2017-01-03
182,001979,招商蛇口,49858950,589643639,0,5900,98235,589741874,2017-01-03
183,002001,新 和 成,21275474,1020384993,4200,6500,129805,1020514798,2017-01-03
184,002004,华邦健康,11577424,840603295,0,11400,104538,840707833,2017-01-03
185,002005,德豪润达,6606031,839580989,0,0,0,839580989,2017-01-03
186,002007,华兰生物,24085926,937206715,0,105451,3775145,940981860,2017-01-03
187,002008,大族激光,18434966,1134193601,19400,100364,2254175,1136447776,2017-01-03
188,002011,盾安环境,7310835,693199309,0,0,0,693199309,2017-01-03
189,002016,世荣兆业,3940620,359574049,0,0,0,359574049,2017-01-03
190,002022,科华生物,26637819,1061004566,0,309,6242,1061010808,2017-01-03
191,002023,海特高新,24359125,612712748,14200,18525,262314,612975062,2017-01-03
192,002024,苏宁云商,174700711,3789313561,488501,1233501,14542977,3803856538,2017-01-03
193,002025,航天电器,0,774262802,0,6800,171360,774434162,2017-01-03
194,002028,思源电气,25966245,499984244,20000,25720,353650,500337894,2017-01-03
195,002029,七 匹 狼,22731828,630476099,0,100,1035,630477134,2017-01-03
196,002030,达安基因,12990598,1182387780,800,841,19520,1182407300,2017-01-03
197,002032,苏 泊 尔,648556,8747474,0,0,0,8747474,2017-01-03
198,002038,双鹭药业,18773287,1198892451,0,9550,261479,1199153930,2017-01-03
199,002041,登海种业,57109518,300157031,47650,81665,1590018,301747049,2017-01-03
200,002042,华孚色纺,30967447,84858400,0,0,0,84858400,2017-01-03
201,002048,宁波华翔,9232536,673710083,6000,8000,178240,673888323,2017-01-03
202,002049,紫光国芯,27196327,1149446724,3500,13000,430690,1149877414,2017-01-03
203,002050,三花智控,13033410,708248738,0,190600,2100412,710349150,2017-01-03
204,002051,中工国际,12213240,551040598,0,122168,2840406,553881004,2017-01-03
205,002055,得润电子,13717440,822878243,0,400,9540,822887783,2017-01-03
206,002056,横店东磁,10008317,599999112,0,18500,259185,600258297,2017-01-03
207,002063,远光软件,17636958,898731310,0,8800,117304,898848614,2017-01-03
208,002064,华峰氨纶,36879980,379303472,8100,8100,44388,379347860,2017-01-03
209,002065,东华软件,86265288,2768771434,30408,62632,1442415,2770213849,2017-01-03
210,002067,景兴纸业,11995972,952682544,0,800,5360,952687904,2017-01-03
211,002070,众和股份,14777492,1651038836,0,0,0,1651038836,2017-01-03
212,002073,软控股份,14768314,506076965,0,135365,1535039,507612004,2017-01-03
213,002078,太阳纸业,20593390,517154603,0,0,0,517154603,2017-01-03
214,002079,苏州固锝,11310637,678445768,0,0,0,678445768,2017-01-03
215,002081,金 螳 螂,21575952,810808690,7300,70850,699998,811508688,2017-01-03
216,002091,江苏国泰,7494025,664533691,0,0,0,664533691,2017-01-03
217,002092,中泰化学,54884299,1173143358,29400,78631,966375,1174109733,2017-01-03
218,002093,国脉科技,12259661,533685026,0,9800,108388,533793414,2017-01-03
219,002095,生 意 宝,16557122,609692785,3600,18600,752928,610445713,2017-01-03
220,002104,恒宝股份,13545103,1187622813,0,0,0,1187622813,2017-01-03
221,002106,莱宝高科,25848091,860634478,9800,57200,661232,861295710,2017-01-03
222,002108,沧州明珠,15624688,1301399192,24300,25600,529408,1301928600,2017-01-03
223,002117,东港股份,29010479,798966993,0,0,0,798966993,2017-01-03
224,002118,紫鑫药业,5749785,571325013,0,60,438,571325451,2017-01-03
225,002128,露天煤业,11450003,575552155,0,0,0,575552155,2017-01-03
226,002129,中环股份,0,791251505,0,900,7443,791258948,2017-01-03
227,002130,沃尔核材,14775299,987647229,0,66500,946295,988593524,2017-01-03
228,002138,顺络电子,8720549,716665758,0,6504,112974,716778732,2017-01-03
229,002140,东华科技,40223852,380339123,0,4400,65428,380404551,2017-01-03
230,002142,宁波银行,41238036,748316199,16000,231880,4034712,752350911,2017-01-03
231,002146,荣盛发展,13383393,725994762,0,18849,147965,726142727,2017-01-03
232,002148,北纬通信,0,811380540,0,1460,28543,811409083,2017-01-03
233,002151,北斗星通,0,420322625,0,3600,114840,420437465,2017-01-03
234,002152,广电运通,25630474,576908868,0,16422,217263,577126131,2017-01-03
235,002153,石基信息,8748594,390713330,9400,51100,1234065,391947395,2017-01-03
236,002154,报 喜 鸟,28803978,714506946,120500,242500,1353150,715860096,2017-01-03
237,002158,汉钟精机,3171903,244791724,0,0,0,244791724,2017-01-03
238,002161,远 望 谷,3147663,776739243,0,21958,257348,776996591,2017-01-03
239,002176,江特电机,22831008,1418230784,0,1435,17450,1418248234,2017-01-03
240,002179,中航光电,50220524,651140077,214700,255425,9780223,660920300,2017-01-03
241,002181,粤 传 媒,13134667,356429348,0,0,0,356429348,2017-01-03
242,002183,怡 亚 通,36801035,2556469337,30000,38700,427635,2556896972,2017-01-03
243,002185,华天科技,24861620,1275883995,0,994,12177,1275896172,2017-01-03
244,002190,成飞集成,18919692,656447155,8700,9864,324230,656771385,2017-01-03
245,002191,劲嘉股份,8231700,713940233,0,0,0,713940233,2017-01-03
246,002202,金风科技,31006817,1060869443,9000,37300,641560,1061511003,2017-01-03
247,002203,海亮股份,4493398,303498065,0,600,4920,303502985,2017-01-03
248,002204,大连重工,22416072,377687067,0,0,0,377687067,2017-01-03
249,002219,恒康医疗,42201896,1316259651,0,0,0,1316259651,2017-01-03
250,002221,东华能源,16608358,828668035,0,0,0,828668035,2017-01-03
251,002223,鱼跃医疗,9916193,681912466,700,74903,2335475,684247941,2017-01-03
252,002229,鸿博股份,15106996,801450674,5200,13964,333321,801783995,2017-01-03
253,002230,科大讯飞,36541090,2355413122,16200,191673,5249923,2360663045,2017-01-03
254,002233,塔牌集团,16794492,450322897,0,1900,18354,450341251,2017-01-03
255,002236,大华股份,15599587,763805893,18100,182700,2501163,766307056,2017-01-03
256,002237,恒邦股份,26169427,890914267,0,1700,19635,890933902,2017-01-03
257,002241,歌尔股份,23001094,1225584520,14600,82155,2236260,1227820780,2017-01-03
258,002242,九阳股份,8961566,458197345,6700,16400,299792,458497137,2017-01-03
259,002244,滨江集团,20582849,623839319,0,0,0,623839319,2017-01-03
260,002250,联化科技,4977256,323325341,2700,15100,249603,323574944,2017-01-03
261,002251,步 步 高,30154520,756312080,7500,117500,1944625,758256705,2017-01-03
262,002252,上海莱士,17036685,1428840820,15000,346435,8026898,1436867718,2017-01-03
263,002261,拓维信息,4674289,1028918693,0,100,1202,1028919895,2017-01-03
264,002262,恩华药业,5845482,363410419,0,0,0,363410419,2017-01-03
265,002266,浙富控股,9399902,858406591,0,0,0,858406591,2017-01-03
266,002267,陕天然气,2690221,292137603,0,0,0,292137603,2017-01-03
267,002268,卫 士 通,11167608,1341549665,0,23700,748446,1342298111,2017-01-03
268,002269,美邦服饰,37160773,305508307,0,31050,157734,305666041,2017-01-03
269,002271,东方雨虹,13672531,55303128,200,200,4330,55307458,2017-01-03
270,002273,水晶光电,26847142,1545725687,0,22620,454210,1546179897,2017-01-03
271,002275,桂林三金,5736302,353842837,0,2000,37160,353879997,2017-01-03
272,002276,万马股份,12987587,1379396624,0,52193,789158,1380185782,2017-01-03
273,002277,友阿股份,59279344,643221012,22200,24065,380227,643601239,2017-01-03
274,002281,光迅科技,94628887,992576889,0,0,0,992576889,2017-01-03
275,002285,世联行,8529401,506641127,0,0,0,506641127,2017-01-03
276,002287,奇正藏药,21175607,361614967,0,20700,931293,362546260,2017-01-03
277,002292,奥飞娱乐,14057995,1312239221,2200,108400,2472604,1314711825,2017-01-03
278,002293,罗莱生活,1621343,213436094,0,5300,71762,213507856,2017-01-03
279,002294,信立泰,3900434,377915477,8200,51746,1544101,379459578,2017-01-03
280,002299,圣农发展,12090897,362007460,700,6258,132357,362139817,2017-01-03
281,002302,西部建设,3724001,42199536,0,0,0,42199536,2017-01-03
282,002304,洋河股份,11769620,415645312,100,54550,3864868,419510180,2017-01-03
283,002307,北新路桥,10465761,367285550,0,0,0,367285550,2017-01-03
284,002308,威创股份,4042845,576057921,0,39415,580189,576638110,2017-01-03
285,002310,东方园林,25180913,950034652,71000,308930,4411520,954446172,2017-01-03
286,002311,海大集团,8932030,228516149,0,0,0,228516149,2017-01-03
287,002312,三泰控股,28048261,1341661902,0,34,299,1341662201,2017-01-03
288,002313,日海通讯,14407571,1137440077,0,6486,151967,1137592044,2017-01-03
289,002317,众生药业,8556155,526843468,0,0,0,526843468,2017-01-03
290,002318,久立特材,7146623,650766537,0,8500,85765,650852302,2017-01-03
291,002325,洪涛股份,8746998,1038668601,0,4000,32320,1038700921,2017-01-03
292,002340,格林美,16937644,1393344040,0,400,2640,1393346680,2017-01-03
293,002344,海宁皮城,19597939,709933813,0,30600,349146,710282959,2017-01-03
294,002353,杰瑞股份,23904435,779511236,7600,36800,744096,780255332,2017-01-03
295,002355,兴民智通,7877408,364420525,0,15000,205500,364626025,2017-01-03
296,002367,康力电梯,13120268,61753390,0,0,0,61753390,2017-01-03
297,002368,太极股份,13498656,606829275,4000,6100,188063,607017338,2017-01-03
298,002369,卓翼科技,7779359,857363381,0,0,0,857363381,2017-01-03
299,002371,七星电子,12763809,478043898,0,0,0,478043898,2017-01-03
300,002372,伟星新材,5349129,21395464,0,0,0,21395464,2017-01-03
301,002375,亚厦股份,13138806,778421812,0,14355,153886,778575698,2017-01-03
302,002378,章源钨业,5046415,576739718,0,100,988,576740706,2017-01-03
303,002385,大北农,16207150,614305002,0,93400,665942,614970944,2017-01-03
304,002393,力生制药,20947778,857934820,0,0,0,857934820,2017-01-03
305,002396,星网锐捷,0,499913185,0,6449,127045,500040230,2017-01-03
306,002399,海普瑞,19386041,736768810,3100,4700,86856,736855666,2017-01-03
307,002400,省广股份,0,422600815,0,26350,363366,422964181,2017-01-03
308,002401,中海科技,11919395,652981260,0,0,0,652981260,2017-01-03
309,002405,四维图新,43099878,1779466521,3400,80674,1577983,1781044504,2017-01-03
310,002407,多氟多,48461486,1991036984,5000,76000,2076320,1993113304,2017-01-03
311,002408,齐翔腾达,0,1213059483,0,0,0,1213059483,2017-01-03
312,002410,广联达,15623626,705100458,3000,11750,171550,705272008,2017-01-03
313,002414,高德红外,7171309,524476811,13800,13824,320717,524797528,2017-01-03
314,002415,海康威视,13927232,1052241517,42700,154850,3753564,1055995081,2017-01-03
315,002416,爱施德,11233987,675224081,0,0,0,675224081,2017-01-03
316,002419,天虹商场,63249656,469126717,10000,100000,1531000,470657717,2017-01-03
317,002424,贵州百灵,12172913,710821868,0,4854,91692,710913560,2017-01-03
318,002428,云南锗业,13029698,830769404,0,33980,437662,831207066,2017-01-03
319,002429,兆驰股份,14162389,762593338,122675,344661,3505202,766098540,2017-01-03
320,002431,棕榈股份,8766632,999819774,0,87,804,999820578,2017-01-03
321,002437,誉衡药业,8835881,800597479,0,0,0,800597479,2017-01-03
322,002439,启明星辰,10330376,597494522,14000,178740,3723154,601217676,2017-01-03
323,002440,闰土股份,0,436456344,0,0,0,436456344,2017-01-03
324,002444,巨星科技,9951191,694849227,0,107800,1697850,696547077,2017-01-03
325,002450,康得新,82561089,3390544198,10000,336084,6425926,3396970124,2017-01-03
326,002456,欧菲光,217640805,1644300438,19000,68928,2216724,1646517162,2017-01-03
327,002460,赣锋锂业,40185825,2204697108,1000,36353,964809,2205661917,2017-01-03
328,002461,珠江啤酒,2482347,203018598,0,0,0,203018598,2017-01-03
329,002465,海格通信,50188150,1158042360,73700,358000,4270940,1162313300,2017-01-03
330,002467,二六三,6297968,725173006,0,82500,875325,726048331,2017-01-03
331,002470,金正大,19584366,406310057,0,25601,201992,406512049,2017-01-03
332,002474,榕基软件,9864788,932693488,0,9366,128314,932821802,2017-01-03
333,002475,立讯精密,37739366,440151598,17900,55500,1082250,441233848,2017-01-03
334,002476,宝莫股份,46139910,1107309774,70000,70100,742359,1108052133,2017-01-03
335,002482,广田集团,18452753,475916286,0,0,0,475916286,2017-01-03
336,002490,山东墨龙,5770410,448823327,55000,85200,834108,449657435,2017-01-03
337,002493,荣盛石化,18516368,404394675,0,0,0,404394675,2017-01-03
338,002500,山西证券,46529001,1945425654,0,276800,3343744,1948769398,2017-01-03
339,002501,利源精制,48884187,1098725129,0,0,0,1098725129,2017-01-03
340,002508,老板电器,5853620,340436051,0,4150,153301,340589352,2017-01-03
341,002518,科士达,9509105,393739806,0,25525,546746,394286552,2017-01-03
342,002521,齐峰新材,23196062,143562000,0,0,0,143562000,2017-01-03
343,002524,光正集团,25036220,697382589,0,30000,316200,697698789,2017-01-03
344,002556,辉隆股份,253332106,829817291,130000,140000,1548400,831365691,2017-01-03
345,002557,洽洽食品,10685561,51008944,0,0,0,51008944,2017-01-03
346,002563,森马服饰,2697456,10950788,0,0,0,10950788,2017-01-03
347,002570,贝因美,14199877,479399978,0,76628,1028348,480428326,2017-01-03
348,002571,德力股份,0,563403755,0,0,0,563403755,2017-01-03
349,002573,清新环境,10988644,707650368,16500,70038,1229867,708880235,2017-01-03
350,002574,明牌珠宝,12416415,447749396,0,0,0,447749396,2017-01-03
351,002577,雷柏科技,8492581,670380216,600,2438,74140,670454356,2017-01-03
352,002579,中京电子,0,442929647,0,0,0,442929647,2017-01-03
353,002588,史丹利,9441848,87276923,0,0,0,87276923,2017-01-03
354,002594,比亚迪,33329130,1671532087,31000,80917,4032094,1675564181,2017-01-03
355,002595,豪迈科技,2773966,7233236,0,0,0,7233236,2017-01-03
356,002603,以岭药业,13585353,634514121,0,11900,208726,634722847,2017-01-03
357,002642,荣之联,12050160,847199500,6500,9325,187712,847387212,2017-01-03
358,002646,青青稞酒,6983929,491898496,15000,15000,289200,492187696,2017-01-03
359,002648,卫星石化,5656919,192082478,0,2300,28129,192110607,2017-01-03
360,002653,海思科,13891701,219190330,0,26100,416817,219607147,2017-01-03
361,002662,京威股份,6697708,52084140,0,0,0,52084140,2017-01-03
362,002673,西部证券,66413615,4355336434,6000,352228,7368610,4362705044,2017-01-03
363,002681,奋达科技,0,503050157,0,11900,153867,503204024,2017-01-03
364,002701,奥瑞金,26953803,776286925,0,0,0,776286925,2017-01-03
365,002736,国信证券,10243413,73219224,0,0,0,73219224,2017-01-03
366,159901,深100ETF,1133585,607308206,68700,1169201,4656927,611965133,2017-01-03
367,159902,中 小 板,2267461,60964679,228500,3863835,12086075,73050754,2017-01-03
368,159903,深成ETF,13769,28797632,0,157900,173058,28970690,2017-01-03
369,159919,300ETF,4150128,2243757093,1232300,9306162,33474265,2277231358,2017-01-03
370,159925,南方300,61258,542321,0,0,0,542321,2017-01-03
371,159933,金地ETF,0,1399831,0,0,0,1399831,2017-01-03
372,300001,特锐德,10676272,648388161,7000,7000,121800,648509961,2017-01-03
373,300002,神州泰岳,13375843,1010217140,0,27900,260307,1010477447,2017-01-03
374,300003,乐普医疗,8360932,424886916,40700,138991,2493499,427380415,2017-01-03
375,300005,探路者,0,617025785,0,2500,41725,617067510,2017-01-03
376,300010,立思辰,16318311,860302819,4100,17391,289560,860592379,2017-01-03
377,300014,亿纬锂能,44236717,1164502770,4000,33300,963702,1165466472,2017-01-03
378,300015,爱尔眼科,6491725,365007364,700,43345,1299483,366306847,2017-01-03
379,300017,网宿科技,32100584,2245294001,3100,156181,8433774,2253727775,2017-01-03
380,300020,银江股份,29940933,1327715793,13300,13300,210805,1327926598,2017-01-03
381,300024,机器人,22988034,1927866969,26100,345080,7405417,1935272386,2017-01-03
382,300026,红日药业,6553904,782899326,0,1000,5500,782904826,2017-01-03
383,300027,华谊兄弟,20834289,1936112052,31100,314377,3464434,1939576486,2017-01-03
384,300034,钢研高纳,17444494,568085618,0,0,0,568085618,2017-01-03
385,300039,上海凯宝,11710216,759658570,0,0,0,759658570,2017-01-03
386,300052,中青宝,65212200,796930453,15000,83100,2011851,798942304,2017-01-03
387,300053,欧比特,18019431,1039576097,3200,12200,174704,1039750801,2017-01-03
388,300055,万邦达,10319747,944812244,2000,9908,163086,944975330,2017-01-03
389,300058,蓝色光标,60644267,1043734798,0,121284,1211627,1044946425,2017-01-03
390,300059,东方财富,175417750,6278578306,11000,259569,4433439,6283011745,2017-01-03
391,300065,海兰信,0,747905588,0,0,0,747905588,2017-01-03
392,300070,碧水源,25586361,1101493048,49500,166586,2970228,1104463276,2017-01-03
393,300072,三聚环保,75433828,2599146167,4800,5119,235320,2599381487,2017-01-03
394,300074,华平股份,20347064,827530830,0,0,0,827530830,2017-01-03
395,300077,国民技术,37515598,1917374199,3400,3400,55454,1917429653,2017-01-03
396,300079,数码视讯,14118672,1451704771,0,0,0,1451704771,2017-01-03
397,300088,长信科技,0,1447082602,0,23924,377999,1447460601,2017-01-03
398,300090,盛运环保,76748468,1459790906,0,217200,2541240,1462332146,2017-01-03
399,300093,金刚玻璃,22663885,919056669,0,0,0,919056669,2017-01-03
400,300104,乐视网,0,4508755154,0,50580,1810764,4510565918,2017-01-03
401,300115,长盈精密,61482623,420063526,500,500,11900,420075426,2017-01-03
402,300122,智飞生物,2658098,378097493,0,12000,200280,378297773,2017-01-03
403,300124,汇川技术,17235288,811289158,10500,244996,4948919,816238077,2017-01-03
404,300128,锦富新材,34123415,1019901799,0,20000,335400,1020237199,2017-01-03
405,300133,华策影视,19180028,1043091635,0,105835,1212869,1044304504,2017-01-03
406,300134,大富科技,12442089,1153826798,8000,9400,240828,1154067626,2017-01-03
407,300146,汤臣倍健,18251277,861912316,0,44400,531912,862444228,2017-01-03
408,300147,香雪制药,19287353,704544665,4400,4400,57552,704602217,2017-01-03
409,300152,科融环境,11302994,784719434,5000,5600,42056,784761490,2017-01-03
410,300157,恒泰艾普,13004903,894053093,0,0,0,894053093,2017-01-03
411,300168,万达信息,44934899,1913742955,174700,302772,6140216,1919883171,2017-01-03
412,300170,汉得信息,24089476,1227710429,27500,27500,328625,1228039054,2017-01-03
413,300191,潜能恒信,12683130,701995025,0,70000,2419200,704414225,2017-01-03
414,300199,翰宇药业,12759846,763970647,0,0,0,763970647,2017-01-03
415,300202,聚龙股份,36359051,596743410,0,7000,165410,596908820,2017-01-03
416,300203,聚光科技,29177441,704454892,600,15573,474665,704929557,2017-01-03
417,300205,天喻信息,25346815,672082699,3500,30939,449234,672531933,2017-01-03
418,300212,易华录,0,880091830,0,10069,342346,880434176,2017-01-03
419,300216,千山药机,21219206,1410369676,800,1200,42060,1410411736,2017-01-03
420,300226,上海钢联,11401421,860276449,1400,1400,56910,860333359,2017-01-03
421,300228,富瑞特装,10881392,1010836662,0,2270,29170,1010865832,2017-01-03
422,300251,光线传媒,16028469,1131807102,45400,256242,2531670,1134338772,2017-01-03
423,300253,卫宁健康,20756545,1378112898,59900,286402,5636391,1383749289,2017-01-03
424,300257,开山股份,17960039,767294237,0,1300,21957,767316194,2017-01-03
425,300273,和佳股份,39710482,944343154,25000,111800,1990040,946333194,2017-01-03
426,300274,阳光电源,21481189,926122920,31600,102940,1077782,927200702,2017-01-03
427,300315,掌趣科技,63381434,2618319890,79800,166400,1547520,2619867410,2017-01-03
428,300355,蒙草生态,51774565,932164441,0,158400,1595088,933759529,2017-01-03
429,300498,温氏股份,42750699,384480874,0,0,0,384480874,2017-01-03
